inci_no,Year,Season,Alm_Date,Address,Incident Type,Incident Type Number,Inci_type,Content_Loss,Property_Loss,Total_Loss,Pre_Inci_Value,Saved
7866,2012,Spring,4/1/2012,217 W ST CATHERINE n/a City of Louisville KY 40203,Structure Fire,112,112 - Fires in structure other than in a building,1000,2000,3000,80000,77000
8072,2012,Spring,4/3/2012,3153 TALISMAN N/A City of Cambridge KY 40220,Structure Fire,111,111 - Building fire,0,5000,5000,127000,122000
8132,2012,Spring,4/4/2012,RUNDILL MAP 4 City of Louisville KY 40214,Vehicle Fire,131,131 - Passenger vehicle fire,0,4000,4000,4000,0
8316,2012,Spring,4/6/2012,1150 S 28TH n/a City of Louisville KY 40211,Structure Fire,111,111 - Building fire,0,5000,5000,50000,45000
8322,2012,Spring,4/6/2012,3308 HALE n/a City of Louisville KY 40211,Structure Fire,111,111 - Building fire,0,5000,5000,5000,0
8438,2012,Spring,4/7/2012,S SHELBY City of Louisville KY 40203,Vehicle Fire,131,131 - Passenger vehicle fire,0,250,250,1500,1250
8520,2012,Spring,4/8/2012,100 HIGH RISE n/a City of Audubon Park KY 40213,Structure Fire,111,111 - Building fire,500,500,1000,1000000,999000
8528,2012,Spring,4/8/2012,740 I 264 East n/a City of Louisville KY 40215,Vehicle Fire,131,131 - Passenger vehicle fire,0,3000,3000,6000,3000
8854,2012,Spring,4/12/2012,6708 SEMINOLE n/a City of Louisville KY 40214,Structure Fire,111,111 - Building fire,30000,60000,90000,225000,135000
8857,2012,Spring,4/12/2012,1601 GAGEL front entrance City of Louisville KY 40216,Outside Fire,164,164 - Outside mailbox fire,0,200,200,500000,499800
8879,2012,Spring,4/12/2012,419 N 28TH None City of Louisville KY 40212,Structure Fire,118,"118 - Trash or rubbish fire, contained",0,100,100,500,400
8953,2012,Spring,4/13/2012,144 BRECKENRIDGE 4 City of Beechwood Village KY 40207,Structure Fire,111,111 - Building fire,500,1000,1500,1000,-500
8973,2012,Spring,4/13/2012,3025 KLONWAY N/A City of Cambridge KY 40220,Structure Fire,111,111 - Building fire,20000,40000,60000,120000,60000
9042,2012,Spring,4/14/2012,1125 MULBERRY n/a City of Louisville KY 40217,Structure Fire,111,111 - Building fire,500,500,1000,118000,117000
9049,2012,Spring,4/14/2012,1610 BULGER B City of Louisville KY 40210,Structure Fire,111,111 - Building fire,20000,100000,120000,400000,280000
9169,2012,Spring,4/15/2012,2907 S 6TH 0 City of Louisville KY 40208,Structure Fire,111,111 - Building fire,500,1000,1500,7000,5500
9272,2012,Spring,4/16/2012,215 ALBANY N/A City of Louisville KY 40206,Structure Fire,111,111 - Building fire,250,2000,2250,105000,102750
9500,2012,Spring,4/19/2012,934 FRANKLIN 4 City of Louisville KY 40206,Structure Fire,111,111 - Building fire,2000,30000,32000,100000,68000
9529,2012,Spring,4/19/2012,605 SCHOLAR HOUSE 306 City of Louisville KY 40217,Structure Fire,113,"113 - Cooking fire, confined to container",3000,5000,8000,500000,492000
9793,2012,Spring,4/22/2012,517 M n/a City of Louisville KY 40208,Structure Fire,111,111 - Building fire,300,1000,1300,1000,-300
9793,2012,Spring,4/22/2012,515 M n/a City of Louisville KY 40208,Structure Fire,111,111 - Building fire,0,300,300,800,500
9876,2012,Spring,4/23/2012,3315 GREENWOOD N/A City of Louisville KY 40211,Vehicle Fire,131,131 - Passenger vehicle fire,0,2000,2000,2500,500
9896,2012,Spring,4/24/2012,1415 WEYLER N/A City of Louisville KY 40215,Structure Fire,111,111 - Building fire,20000,50000,70000,125000,55000
10104,2012,Spring,4/26/2012,303 E BRANDEIS n/a City of Louisville KY 40208,Vehicle Fire,131,131 - Passenger vehicle fire,100,500,600,7000,6400
10179,2012,Spring,4/27/2012,959 CHARLES NA City of Louisville KY 40204,Structure Fire,111,111 - Building fire,10000,50000,60000,75000,15000
10179,2012,Spring,4/27/2012,959 CHARLES NA City of Louisville KY 40204,Structure Fire,111,111 - Building fire,0,5000,5000,80000,75000
10179,2012,Spring,4/27/2012,959 CHARLES NA City of Louisville KY 40204,Structure Fire,111,111 - Building fire,0,5000,5000,80000,75000
10305,2012,Spring,4/28/2012,120 I 64 West n/a City of Louisville KY 40212,Vehicle Fire,131,131 - Passenger vehicle fire,0,1000,1000,1000,0
10343,2012,Spring,4/28/2012,1693 GARLAND N/A City of Louisville KY 40210,Structure Fire,113,"113 - Cooking fire, confined to container",0,250,250,400,150
10472,2012,Spring,4/29/2012,1239 S CLAY n/a City of Louisville KY 40203,Structure Fire,111,111 - Building fire,1000,10000,11000,69500,58500
10527,2012,Spring,4/30/2012,301 N 44TH N/A City of Louisville KY 40212,Structure Fire,111,111 - Building fire,2500,10000,12500,80000,67500
10592,2012,Summer,5/1/2012,2325 DUNCAN None City of Louisville KY 40212,Structure Fire,118,"118 - Trash or rubbish fire, contained",500,0,500,0,-500
10643,2012,Summer,5/1/2012,700 CENTRAL n/a City of Louisville KY 40208,Structure Fire,111,111 - Building fire,0,450,450,150000,149550
10674,2012,Summer,5/1/2012,433 S 2ND 102 City of Louisville KY 40202,Structure Fire,113,"113 - Cooking fire, confined to container",1500,200,1700,200,-1500
10941,2012,Summer,5/4/2012,2800 YORKSHIRE n/a City of Cambridge KY 40220,Structure Fire,113,"113 - Cooking fire, confined to container",0,400,400,60000,59600
10947,2012,Summer,5/4/2012,GREENWOOD City of Louisville KY 40211,Vehicle Fire,130,"130 - Mobile property (vehicle) fire, other",0,500,500,500,0
11012,2012,Summer,5/4/2012,2319 DIXDALE na City of Louisville KY 40210,Structure Fire,111,111 - Building fire,8000,15000,23000,46000,23000
11157,2012,Summer,5/6/2012,664 S 40TH n/a City of Louisville KY 40211,Vehicle Fire,131,131 - Passenger vehicle fire,250,2500,2750,5000,2250
11341,2012,Summer,5/7/2012,1327 TEMPLE 1 City of Louisville KY 40210,Outside Fire,162,162 - Outside equipment fire,0,100,100,49000,48900
11443,2012,Summer,5/8/2012,934 FRANKLIN n/a City of Louisville KY 40206,Structure Fire,111,111 - Building fire,10000,80000,90000,96960,6960
11762,2012,Summer,5/11/2012,ALLMOND City of Louisville KY 40209,Outside Fire,162,162 - Outside equipment fire,5000,0,5000,0,-5000
11678,2012,Summer,5/11/2012,S 35TH City of Louisville KY 40211,Vehicle Fire,131,131 - Passenger vehicle fire,0,11000,11000,11000,0
11684,2012,Summer,5/11/2012,3565 FINCASTLE N/A City of Audubon Park KY 40213,Structure Fire,111,111 - Building fire,100,0,100,200000,199900
11759,2012,Summer,5/11/2012,412 W LEE n/a City of Louisville KY 40217,Vehicle Fire,131,131 - Passenger vehicle fire,2500,2500,5000,2500,-2500
11799,2012,Summer,5/12/2012,743 S SHELBY N/A City of Louisville KY 40203,Structure Fire,111,111 - Building fire,4000,50000,54000,150000,96000
11828,2012,Summer,5/12/2012,1839 W GAULBERT N/A City of Louisville KY 40210,Structure Fire,111,111 - Building fire,0,50,50,50,0
11846,2012,Summer,5/12/2012,1680 I 264 East N/A City of Cambridge KY 40220,Vehicle Fire,131,131 - Passenger vehicle fire,0,7500,7500,7500,0
11871,2012,Summer,5/13/2012,1501 DIXIE N/A City of Louisville KY 40210,Vehicle Fire,131,131 - Passenger vehicle fire,0,15000,15000,35000,20000
11901,2012,Summer,5/13/2012,1101 E WASHINGTON N/A City of Louisville KY 40206,Structure Fire,111,111 - Building fire,500,10000,10500,450000,439500
11934,2012,Summer,5/13/2012,4122 S 2ND n/a City of Louisville KY 40214,Structure Fire,111,111 - Building fire,5000,20000,25000,120000,95000
11941,2012,Summer,5/14/2012,1361 S FLOYD 14 City of Louisville KY 40208,Structure Fire,111,111 - Building fire,0,500,500,500,0
12016,2012,Summer,5/14/2012,107 FENLEY S-2 City of Beechwood Village KY 40207,Vehicle Fire,131,131 - Passenger vehicle fire,0,3000,3000,3000,0
12163,2012,Summer,5/16/2012,425 WARNOCK n/a City of Louisville KY 40217,Vehicle Fire,131,131 - Passenger vehicle fire,300,5000,5300,5000,-300
12250,2012,Summer,5/17/2012,530 AMY 1 City of Louisville KY 40211,Structure Fire,113,"113 - Cooking fire, confined to container",150,0,150,NULL,NULL
12288,2012,Summer,5/17/2012,CONN City of Louisville KY 40215,Vehicle Fire,131,131 - Passenger vehicle fire,1000,9000,10000,9000,-1000
12383,2012,Summer,5/18/2012,3314 W MAIN n/a City of Louisville KY 40212,Structure Fire,111,111 - Building fire,0,25000,25000,50000,25000
12425,2012,Summer,5/18/2012,7417 STEEPLECREST 304 City of Bancroft KY 40222,Structure Fire,111,111 - Building fire,5000,15000,20000,500000,480000
12436,2012,Summer,5/19/2012,1200 I 264 East n/a City of Audubon Park KY 40213,Vehicle Fire,131,131 - Passenger vehicle fire,0,4000,4000,4000,0
12499,2012,Summer,5/19/2012,S 9TH City of Louisville KY 40208,Vehicle Fire,131,131 - Passenger vehicle fire,0,1000,1000,2000,1000
12526,2012,Summer,5/19/2012,409 E MUHAMMAD ALI 1106 City of Louisville KY 40202,Structure Fire,111,111 - Building fire,500,200,700,200,-500
12529,2012,Summer,5/19/2012,1708 W OAK N/A City of Louisville KY 40210,Structure Fire,112,112 - Fires in structure other than in a building,0,300,300,300,0
12538,2012,Summer,5/19/2012,1718 W JEFFERSON N/A City of Louisville KY 40203,Structure Fire,111,111 - Building fire,0,20000,20000,150000,130000
12845,2012,Summer,5/23/2012,719 SUTCLIFFE n/a City of Louisville KY 40211,Vehicle Fire,131,131 - Passenger vehicle fire,0,2875,2875,2875,0
12846,2012,Summer,5/23/2012,402 N HITE n/a City of Louisville KY 40206,Vehicle Fire,131,131 - Passenger vehicle fire,0,5000,5000,25000,20000
12958,2012,Summer,5/24/2012,2804 7TH STREET N/A City of Louisville KY 40215,Structure Fire,111,111 - Building fire,100000,120000,220000,120000,-100000
13033,2012,Summer,5/24/2012,S 2ND City of Louisville KY 40202,Outside Fire,151,"151 - Outside rubbish, trash or waste fire",0,200,200,200,0
13034,2012,Summer,5/24/2012,555 S 2ND on sidewalk City of Louisville KY 40202,Outside Fire,151,"151 - Outside rubbish, trash or waste fire",0,200,200,200,0
13058,2012,Summer,5/24/2012,2045 RIVER na City of Louisville KY 40206,Outside Fire,162,162 - Outside equipment fire,0,200000,200000,2000000,1800000
13073,2012,Summer,5/25/2012,3520 LEITH N/A City of Louisville KY 40218,Vehicle Fire,137,137 - Camper or recreational vehicle (RV) fire,5000,25000,30000,25000,-5000
13182,2012,Summer,5/26/2012,2640 FRANKFORT N/A City of Louisville KY 40206,Structure Fire,111,111 - Building fire,0,500,500,200000,199500
13213,2012,Summer,5/26/2012,12980 I 65 North n/a City of Audubon Park KY 40213,Vehicle Fire,131,131 - Passenger vehicle fire,0,2000,2000,4000,2000
13316,2012,Summer,5/27/2012,3003 SHOREHAM n/a City of Louisville KY 40216,Structure Fire,111,111 - Building fire,5000,20000,25000,60000,35000
13316,2012,Summer,5/27/2012,3005 SHOREHAM n/a City of Louisville KY 40216,Structure Fire,111,111 - Building fire,2500,10000,12500,60000,47500
13369,2012,Summer,5/28/2012,2827 HALE N/A City of Louisville KY 40211,Structure Fire,112,112 - Fires in structure other than in a building,0,50000,50000,250000,200000
13395,2012,Summer,5/28/2012,12980 I 65 North NA City of Audubon Park KY 40213,Vehicle Fire,131,131 - Passenger vehicle fire,500,1500,2000,1500,-500
13449,2012,Summer,5/29/2012,602 RUGGLES 323 City of Louisville KY 40208,Structure Fire,111,111 - Building fire,15000,150000,165000,1250000,1085000
13498,2012,Summer,5/29/2012,3126 MYLANTA N/A City of Cambridge KY 40220,Structure Fire,113,"113 - Cooking fire, confined to container",1000,0,1000,0,-1000
13503,2012,Summer,5/29/2012,4400BLK MANSLICK na City of Louisville KY 40216,Vehicle Fire,131,131 - Passenger vehicle fire,1000,3000,4000,7000,3000
13795,2012,Summer,6/1/2012,1704 LIBERTY BELL 4 City of Louisville KY 40215,Structure Fire,111,111 - Building fire,25000,60000,85000,160000,75000
13844,2012,Summer,6/2/2012,2905 ROWAN 0 City of Louisville KY 40212,Vehicle Fire,130,"130 - Mobile property (vehicle) fire, other",0,10000,10000,10000,0
13865,2012,Summer,6/2/2012,2018 VILLAGE 3 City of Kingsley KY 40205,Structure Fire,113,"113 - Cooking fire, confined to container",200,0,200,0,-200
13955,2012,Summer,6/3/2012,441 WILBERFORCE N/A City of Louisville KY 40203,Structure Fire,111,111 - Building fire,0,1000,1000,7310230,7309230
13963,2012,Summer,6/3/2012,1204 POTOMAC na City of Louisville KY 40214,Structure Fire,111,111 - Building fire,0,700,700,700,0
14005,2012,Summer,6/4/2012,1210 CECIL n/a City of Louisville KY 40211,Structure Fire,111,111 - Building fire,10000,20000,30000,46480,16480
14236,2012,Summer,6/6/2012,305 E KENTUCKY 1 City of Louisville KY 40203,Structure Fire,113,"113 - Cooking fire, confined to container",150,0,150,0,-150
14274,2012,Summer,6/6/2012,1812 LYTLE N/A City of Louisville KY 40203,Structure Fire,111,111 - Building fire,1000,30000,31000,30000,-1000
14276,2012,Summer,6/6/2012,1614 CYPRESS na City of Louisville KY 40210,Vehicle Fire,131,131 - Passenger vehicle fire,0,2500,2500,2500,0
14330,2012,Summer,6/7/2012,4733 S 1ST 1 City of Louisville KY 40214,Structure Fire,113,"113 - Cooking fire, confined to container",2000,2000,4000,2000,-2000
14380,2012,Summer,6/7/2012,S 30TH City of Louisville KY 40211,Vehicle Fire,130,"130 - Mobile property (vehicle) fire, other",0,500,500,500,0
14392,2012,Summer,6/8/2012,4303 GREENWOOD na City of Louisville KY 40211,Structure Fire,111,111 - Building fire,0,12000,12000,40000,28000
14410,2012,Summer,6/8/2012,1507 S 35TH n/a City of Louisville KY 40211,Structure Fire,111,111 - Building fire,10000,20000,30000,56410,26410
14484,2012,Summer,6/8/2012,1200 MAPLE n/a City of Louisville KY 40210,Structure Fire,111,111 - Building fire,5000,5000,10000,1168600,1158600
14532,2012,Summer,6/9/2012,170 BRECKINRIDGE n/a City of Cambridge KY 40220,Outside Fire,160,"160 - Special outside fire, other",0,250,250,1000,750
14546,2012,Summer,6/9/2012,1031 EVERETT 2 City of Louisville KY 40204,Structure Fire,111,111 - Building fire,500,500,1000,500000,499000
14594,2012,Summer,6/10/2012,S 7TH City of Louisville KY 40202,Vehicle Fire,131,131 - Passenger vehicle fire,0,2500,2500,2500,0
14773,2012,Summer,6/11/2012,S 3RD City of Louisville KY 40202,Outside Fire,151,"151 - Outside rubbish, trash or waste fire",0,200,200,200,0
14867,2012,Summer,6/12/2012,CONN City of Louisville KY 40215,Outside Fire,151,"151 - Outside rubbish, trash or waste fire",0,200,200,200,0
14892,2012,Summer,6/13/2012,2320 COLUMBIA N/A City of Louisville KY 40212,Structure Fire,111,111 - Building fire,0,20000,20000,20000,0
14937,2012,Summer,6/13/2012,1719 W KENTUCKY room City of Louisville KY 40210,Structure Fire,111,111 - Building fire,150,0,150,NULL,NULL
14988,2012,Summer,6/13/2012,102 KENWOOD 44 City of Louisville KY 40214,Structure Fire,113,"113 - Cooking fire, confined to container",50,1000,1050,200000,198950
14892,2012,Summer,6/13/2012,2318 COLUMBIA N/A City of Louisville KY 40212,Structure Fire,111,111 - Building fire,4000,25000,29000,45000,16000
14892,2012,Summer,6/13/2012,2319 ROWAN N/A City of Louisville KY 40212,Structure Fire,111,111 - Building fire,0,5000,5000,18000,13000
14892,2012,Summer,6/13/2012,2319 Rowan N/A City of Louisville KY 40212,Outside Fire,161,161 - Outside storage fire,0,1000,1000,2000,1000
14892,2012,Summer,6/13/2012,2319 ROWAN N/A City of Louisville KY 40212,Structure Fire,111,111 - Building fire,0,500,500,31500,31000
15011,2012,Summer,6/14/2012,1739 BOLLING room City of Louisville KY 40210,Structure Fire,111,111 - Building fire,6000,10000,16000,21000,5000
15091,2012,Summer,6/15/2012,HIAWATHA City of Louisville KY 40209,Vehicle Fire,131,131 - Passenger vehicle fire,0,3000,3000,3000,0
15268,2012,Summer,6/16/2012,657 BARRET N/A City of Louisville KY 40204,Vehicle Fire,130,"130 - Mobile property (vehicle) fire, other",0,200,200,200,0
15340,2012,Summer,6/17/2012,2600 LE BLANC 8 City of Louisville KY 40206,Structure Fire,111,111 - Building fire,4000,10000,14000,520000,506000
15405,2012,Summer,6/18/2012,300 S Clay 303 City of Louisville KY 40202,Structure Fire,111,111 - Building fire,1500,2000,3500,300000,296500
15422,2012,Summer,6/18/2012,S 3RD City of Louisville KY 40214,Vehicle Fire,131,131 - Passenger vehicle fire,0,500,500,10000,9500
15518,2012,Summer,6/19/2012,447 S 32ND na City of Louisville KY 40212,Structure Fire,111,111 - Building fire,10000,20000,30000,20000,-10000
15691,2012,Summer,6/21/2012,1835 CARL NA City of Louisville KY 40215,Outside Fire,161,161 - Outside storage fire,0,200,200,300,100
15697,2012,Summer,6/21/2012,913 DRESDEN na City of Louisville KY 40215,Structure Fire,111,111 - Building fire,0,10000,10000,70000,60000
15735,2012,Summer,6/21/2012,4411 S 2ND n/a City of Louisville KY 40214,Vehicle Fire,131,131 - Passenger vehicle fire,0,2000,2000,4000,2000
15758,2012,Summer,6/21/2012,3819 RIVER PARK N/A City of Louisville KY 40211,Structure Fire,111,111 - Building fire,0,500,500,50000,49500
15761,2012,Summer,6/21/2012,404 S 41ST N/A City of Louisville KY 40212,Structure Fire,111,111 - Building fire,0,10000,10000,60000,50000
15779,2012,Summer,6/21/2012,13200 I 65 North n/a City of Audubon Park KY 40213,Vehicle Fire,131,131 - Passenger vehicle fire,0,4000,4000,4000,0
15811,2012,Summer,6/22/2012,315 S 10TH n\a City of Louisville KY 40203,Structure Fire,111,111 - Building fire,0,100,100,100,0
15884,2012,Summer,6/22/2012,S 25TH City of Louisville KY 40210,Vehicle Fire,130,"130 - Mobile property (vehicle) fire, other",0,7000,7000,7000,0
15884,2012,Summer,6/22/2012,2333 W Lee N/A City of Louisville KY 40210,Vehicle Fire,130,"130 - Mobile property (vehicle) fire, other",0,7000,7000,26000,19000
15997,2012,Summer,6/24/2012,3662 ELDERWOOD NA City of Louisville KY 40215,Outside Fire,160,"160 - Special outside fire, other",200,500,700,5000,4300
16008,2012,Summer,6/24/2012,BARDSTOWN City of Kingsley KY 40205,Outside Fire,160,"160 - Special outside fire, other",20,50,70,50,-20
16009,2012,Summer,6/24/2012,2111 CEDAR N/A City of Louisville KY 40212,Structure Fire,111,111 - Building fire,5000,23580,28580,23580,-5000
16064,2012,Summer,6/24/2012,1446 BELMAR N/A City of Audubon Park KY 40213,Outside Fire,143,143 - Grass fire,0,500,500,25000,24500
16077,2012,Summer,6/24/2012,TAYLOR City of Louisville KY 40215,Outside Fire,140,"140 - Natural vegetation fire, other",0,400,400,600,200
16009,2012,Summer,6/24/2012,2109 CEDAR N/A City of Louisville KY 40212,Structure Fire,111,111 - Building fire,10000,22440,32440,22440,-10000
16009,2012,Summer,6/24/2012,2113 CEDAR N/A City of Louisville KY 40212,Structure Fire,111,111 - Building fire,15000,20610,35610,20610,-15000
16009,2012,Summer,6/24/2012,2115 CEDAR N/A City of Louisville KY 40212,Structure Fire,111,111 - Building fire,0,1000,1000,20610,19610
16153,2012,Summer,6/25/2012,I 264 East n/a City of Louisville KY 40215,Vehicle Fire,131,131 - Passenger vehicle fire,0,500,500,500,0
16231,2012,Summer,6/26/2012,2211 OSAGE n/a City of Louisville KY 40210,Structure Fire,111,111 - Building fire,0,400,400,400,0
16238,2012,Summer,6/26/2012,313 SOUTHWESTERN None City of Louisville KY 40212,Structure Fire,111,111 - Building fire,0,200,200,5000,4800
16388,2012,Summer,6/28/2012,1526 HEMLOCK n/a City of Louisville KY 40211,Structure Fire,112,112 - Fires in structure other than in a building,0,10000,10000,30000,20000
16394,2012,Summer,6/28/2012,W MUHAMMAD ALI City of Louisville KY 40212,Vehicle Fire,131,131 - Passenger vehicle fire,0,2000,2000,2000,0
16423,2012,Summer,6/28/2012,510 W BROADWAY n/a City of Louisville KY 40202,Vehicle Fire,131,131 - Passenger vehicle fire,0,3500,3500,3500,0
16448,2012,Summer,6/28/2012,950 I 264 West n/a City of Louisville KY 40209,Vehicle Fire,131,131 - Passenger vehicle fire,0,3000,3000,3000,0
16423,2012,Summer,6/28/2012,510 W BROADWAY n/a City of Louisville KY 40202,Vehicle Fire,131,131 - Passenger vehicle fire,0,1500,1500,10000,8500
16494,2012,Summer,6/28/2012,1521 HALE N/A City of Louisville KY 40210,Structure Fire,111,111 - Building fire,0,15000,15000,35000,20000
16641,2012,Summer,6/30/2012,2316 DUMESNIL N/A City of Louisville KY 40210,Vehicle Fire,131,131 - Passenger vehicle fire,0,1000,1000,3000,2000
16645,2012,Summer,6/30/2012,3422 TAYLOR N/A City of Louisville KY 40215,Structure Fire,113,"113 - Cooking fire, confined to container",8000,2000,10000,318000,308000
16720,2012,Summer,6/30/2012,900 I 264 East NA City of Louisville KY 40215,Vehicle Fire,131,131 - Passenger vehicle fire,500,2000,2500,2000,-500
16724,2012,Summer,6/30/2012,1885 BROWNSBORO N/A City of Louisville KY 40206,Structure Fire,111,111 - Building fire,0,10000,10000,125000,115000
16753,2012,Summer,7/1/2012,BARDSTOWN City of Kingsley KY 40205,Outside Fire,154,154 - Dumpster or other outside trash receptacle fire,0,10,10,10,0
16821,2012,Summer,7/1/2012,4303 S 3RD n/a City of Louisville KY 40214,Structure Fire,111,111 - Building fire,20000,40000,60000,140000,80000
16974,2012,Summer,7/2/2012,816 DRESDEN 0 City of Louisville KY 40215,Vehicle Fire,134,134 - Water vehicle fire,0,500,500,500,0
16976,2012,Summer,7/2/2012,S 16TH City of Louisville KY 40210,Structure Fire,111,111 - Building fire,1500,2500,4000,37090,33090
17023,2012,Summer,7/2/2012,651 S 39TH n/a City of Louisville KY 40211,Vehicle Fire,131,131 - Passenger vehicle fire,0,1000,1000,1000,0
17066,2012,Summer,7/3/2012,1907 S 4TH N/A City of Louisville KY 40208,Vehicle Fire,131,131 - Passenger vehicle fire,0,500,500,2000,1500
17076,2012,Summer,7/3/2012,1915 S 4TH n/a City of Louisville KY 40208,Vehicle Fire,131,131 - Passenger vehicle fire,0,700,700,2000,1300
17102,2012,Summer,7/3/2012,3636 MANSLICK n/a City of Louisville KY 40215,Vehicle Fire,131,131 - Passenger vehicle fire,0,1000,1000,1000,0
17105,2012,Summer,7/3/2012,2247 W KENTUCKY N/A City of Louisville KY 40210,Vehicle Fire,130,"130 - Mobile property (vehicle) fire, other",0,2000,2000,2000,0
17190,2012,Summer,7/4/2012,VIRGINIA NA City of Louisville KY 40211,Vehicle Fire,131,131 - Passenger vehicle fire,0,2000,2000,2000,0
17209,2012,Summer,7/4/2012,2016 GARLAND n/a City of Louisville KY 40210,Outside Fire,142,142 - Brush or brush-and-grass mixture fire,0,5000,5000,10000,5000
17251,2012,Summer,7/4/2012,2831 W MARKET 2 City of Louisville KY 40212,Vehicle Fire,131,131 - Passenger vehicle fire,0,500,500,3000,2500
17265,2012,Summer,7/5/2012,413 MARRET n/a City of Louisville KY 40208,Structure Fire,111,111 - Building fire,0,10000,10000,10000,0
17284,2012,Summer,7/5/2012,S 19TH City of Louisville KY 40203,Vehicle Fire,131,131 - Passenger vehicle fire,0,10000,10000,10000,0
17303,2012,Summer,7/5/2012,S 6TH City of Louisville KY 40202,Vehicle Fire,131,131 - Passenger vehicle fire,1000,5000,6000,5000,-1000
17350,2012,Summer,7/5/2012,1033 S JACKSON N/A City of Louisville KY 40203,Vehicle Fire,131,131 - Passenger vehicle fire,200,1000,1200,2000,800
17265,2012,Summer,7/5/2012,413 MARRET n/a City of Louisville KY 40208,Structure Fire,111,111 - Building fire,0,3000,3000,73000,70000
17388,2012,Summer,7/6/2012,4305 GREENWOOD n/a City of Louisville KY 40211,Structure Fire,111,111 - Building fire,0,500,500,50000,49500
17395,2012,Summer,7/6/2012,2626 W KENTUCKY n/a City of Louisville KY 40211,Structure Fire,111,111 - Building fire,0,250,250,50000,49750
17449,2012,Summer,7/6/2012,3208 DUBLIN N/A City of Louisville KY 40206,Outside Fire,154,154 - Dumpster or other outside trash receptacle fire,0,100,100,100,0
17533,2012,Summer,7/7/2012,138 E WELLINGTON n/a City of Louisville KY 40214,Structure Fire,111,111 - Building fire,1000,4000,5000,74600,69600
17564,2012,Summer,7/7/2012,3283 TAYLOR n/a City of Louisville KY 40215,Structure Fire,111,111 - Building fire,500,2000,2500,50000,47500
17625,2012,Summer,7/7/2012,2311 CRITTENDEN n/a City of Louisville KY 40217,Vehicle Fire,131,131 - Passenger vehicle fire,0,8000,8000,8000,0
17659,2012,Summer,7/8/2012,3204 TAYLOR N/A City of Louisville KY 40215,Structure Fire,111,111 - Building fire,4000,12000,16000,18000,2000
17659,2012,Summer,7/8/2012,3206 TAYLOR N/A City of Louisville KY 40215,Structure Fire,112,112 - Fires in structure other than in a building,0,150,150,200,50
17823,2012,Summer,7/9/2012,1224 I 64 West N/A City of Louisville KY 40212,Vehicle Fire,131,131 - Passenger vehicle fire,0,1500,1500,1500,0
17946,2012,Summer,7/10/2012,3532 GREENWOOD N/A City of Louisville KY 40211,Vehicle Fire,131,131 - Passenger vehicle fire,0,5500,5500,5500,0
18102,2012,Summer,7/12/2012,801 W KENWOOD na City of Louisville KY 40214,Structure Fire,111,111 - Building fire,15000,30000,45000,175000,130000
18159,2012,Summer,7/13/2012,7326 SOUTHSIDE 6C City of Louisville KY 40214,Structure Fire,111,111 - Building fire,2000,5000,7000,10000,3000
18162,2012,Summer,7/13/2012,W SHIPP City of Louisville KY 40208,Vehicle Fire,131,131 - Passenger vehicle fire,0,500,500,3000,2500
18204,2012,Summer,7/13/2012,226 W SOUTHLAND n/a City of Louisville KY 40214,Structure Fire,111,111 - Building fire,40000,40000,80000,120000,40000
18215,2012,Summer,7/13/2012,4625 S 2ND N/A City of Louisville KY 40214,Outside Fire,161,161 - Outside storage fire,0,50,50,50,0
18231,2012,Summer,7/13/2012,5105 S 1ST 1 City of Louisville KY 40214,Structure Fire,111,111 - Building fire,50,50,100,150000,149900
18236,2012,Summer,7/14/2012,S 39TH City of Louisville KY 40212,Vehicle Fire,131,131 - Passenger vehicle fire,0,4000,4000,4000,0
18239,2012,Summer,7/14/2012,3511 GRAND N/A City of Louisville KY 40211,Vehicle Fire,131,131 - Passenger vehicle fire,0,4000,4000,4000,0
18258,2012,Summer,7/14/2012,1040 CHEROKEE E4 City of Louisville KY 40204,Structure Fire,111,111 - Building fire,0,1000,1000,50000,49000
18278,2012,Summer,7/14/2012,3618 NICHOLS MEADOW NA City of Louisville KY 40215,Structure Fire,111,111 - Building fire,1000,2000,3000,90000,87000
18298,2012,Summer,7/14/2012,3538 BROCKTON 2 City of Cambridge KY 40220,Structure Fire,118,"118 - Trash or rubbish fire, contained",0,100,100,250000,249900
18446,2012,Summer,7/16/2012,2615 W JEFFERSON n/a City of Louisville KY 40212,Structure Fire,111,111 - Building fire,0,500,500,28000,27500
18452,2012,Summer,7/16/2012,200 E BROADWAY n/a City of Louisville KY 40202,Vehicle Fire,131,131 - Passenger vehicle fire,0,4000,4000,4000,0
18489,2012,Summer,7/16/2012,2932 S 5TH N/A City of Louisville KY 40208,Structure Fire,111,111 - Building fire,10000,10000,20000,80000,60000
18580,2012,Summer,7/17/2012,S HANCOCK City of Louisville KY 40203,Structure Fire,111,111 - Building fire,0,100,100,1000,900
18592,2012,Summer,7/17/2012,539 LOUIS COLEMAN JR 6 City of Louisville KY 40211,Vehicle Fire,131,131 - Passenger vehicle fire,500,5000,5500,5000,-500
18605,2012,Summer,7/17/2012,2136 W GAULBERT n/a City of Louisville KY 40210,Vehicle Fire,131,131 - Passenger vehicle fire,0,500,500,500,0
18641,2012,Summer,7/18/2012,433 S 2ND 411 City of Louisville KY 40202,Structure Fire,113,"113 - Cooking fire, confined to container",1200,1000,2200,300000,297800
18658,2012,Summer,7/18/2012,2314 MEDFORD N/A City of Louisville KY 40218,Outside Fire,154,154 - Dumpster or other outside trash receptacle fire,100,0,100,0,-100
18699,2012,Summer,7/18/2012,3544 BROCKTON 3 City of Cambridge KY 40220,Structure Fire,111,111 - Building fire,40000,100000,140000,346000,206000
18702,2012,Summer,7/18/2012,223 E OAK N/A City of Louisville KY 40203,Structure Fire,111,111 - Building fire,30000,50000,80000,300000,220000
18772,2012,Summer,7/19/2012,140 N 4TH 5th floor City of Louisville KY 40202,Vehicle Fire,131,131 - Passenger vehicle fire,500,4500,5000,4500,-500
18798,2012,Summer,7/19/2012,1815 W BROADWAY room City of Louisville KY 40203,Vehicle Fire,131,131 - Passenger vehicle fire,0,500,500,1000,500
18842,2012,Summer,7/19/2012,3924 S 3RD N/A City of Louisville KY 40214,Structure Fire,111,111 - Building fire,10000,40000,50000,100000,50000
18927,2012,Summer,7/19/2012,2932 DUMESNIL na City of Louisville KY 40211,Structure Fire,120,"120 - Fire in mobile prop. used as a fixed struc., other",0,500,500,1000,500
19099,2012,Summer,7/21/2012,310 N HITE 9 City of Louisville KY 40206,Structure Fire,111,111 - Building fire,0,500,500,500,0
19143,2012,Summer,7/21/2012,2416 EMIL NA City of Louisville KY 40217,Structure Fire,111,111 - Building fire,2500,20000,22500,116000,93500
19149,2012,Summer,7/21/2012,S 28TH City of Louisville KY 40211,Vehicle Fire,131,131 - Passenger vehicle fire,0,1500,1500,1500,0
19285,2012,Summer,7/23/2012,1023 RUNELL n/a City of Louisville KY 40214,Vehicle Fire,130,"130 - Mobile property (vehicle) fire, other",1000,15000,16000,85000,69000
19375,2012,Summer,7/24/2012,3518 GRAND n/a City of Louisville KY 40211,Structure Fire,111,111 - Building fire,5000,10000,15000,60000,45000
19455,2012,Summer,7/24/2012,1935 FRANKFORT N/A City of Louisville KY 40206,Outside Fire,151,"151 - Outside rubbish, trash or waste fire",0,50,50,50,0
19465,2012,Summer,7/25/2012,208 S SHAWNEE 1 City of Louisville KY 40212,Structure Fire,111,111 - Building fire,0,1000,1000,100000,99000
19523,2012,Summer,7/25/2012,515 S 20TH N/A City of Louisville KY 40203,Structure Fire,111,111 - Building fire,5000,3000,8000,90000,82000
19699,2012,Summer,7/27/2012,1001 BARDSTOWN N/A City of Louisville KY 40204,Structure Fire,113,"113 - Cooking fire, confined to container",2000,0,2000,NULL,NULL
19978,2012,Summer,7/29/2012,434 EASTERN N/A City of Louisville KY 40217,Structure Fire,111,111 - Building fire,2000,2000,4000,364120,360120
19997,2012,Summer,7/30/2012,1237 FISCHER n/a City of Louisville KY 40204,Vehicle Fire,131,131 - Passenger vehicle fire,0,2000,2000,2000,0
20001,2012,Summer,7/30/2012,2300 LEXINGTON N/A City of Louisville KY 40206,Structure Fire,111,111 - Building fire,0,500,500,750000,749500
20042,2012,Summer,7/30/2012,1235 FISCHER n/a City of Louisville KY 40204,Vehicle Fire,131,131 - Passenger vehicle fire,0,2000,2000,2000,0
20167,2012,Summer,7/31/2012,520 MONTANA n/a City of Louisville KY 40208,Structure Fire,111,111 - Building fire,2000,5000,7000,10000,3000
20211,2012,Summer,7/31/2012,740 E KENTUCKY N/A City of Louisville KY 40203,Structure Fire,111,111 - Building fire,0,1000,1000,10000,9000
20336,2012,Autumn,8/2/2012,518 N HITE n/a City of Louisville KY 40206,Structure Fire,111,111 - Building fire,5000,30000,35000,110540,75540
20432,2012,Autumn,8/3/2012,837 S 32ND NA City of Louisville KY 40211,Structure Fire,111,111 - Building fire,0,10000,10000,80000,70000
20459,2012,Autumn,8/3/2012,724 S 38TH 2 City of Louisville KY 40211,Structure Fire,113,"113 - Cooking fire, confined to container",200,0,200,NULL,NULL
20463,2012,Autumn,8/3/2012,1025 S 40TH n/a City of Louisville KY 40211,Structure Fire,111,111 - Building fire,4000,12000,16000,35000,19000
20580,2012,Autumn,8/4/2012,515 SPANISH N/A City of Louisville KY 40214,Structure Fire,111,111 - Building fire,500,5000,5500,89500,84000
20654,2012,Autumn,8/5/2012,3516 RAMONA n/a City of Cambridge KY 40220,Structure Fire,112,112 - Fires in structure other than in a building,50,0,50,0,-50
20665,2012,Autumn,8/5/2012,1821 W OAK N/A City of Louisville KY 40210,Structure Fire,111,111 - Building fire,15000,35000,50000,75000,25000
20665,2012,Autumn,8/5/2012,1823 W OAK N/A City of Louisville KY 40210,Structure Fire,111,111 - Building fire,0,3000,3000,85000,82000
20709,2012,Autumn,8/6/2012,700 W OAK REAR City of Louisville KY 40203,Vehicle Fire,131,131 - Passenger vehicle fire,0,1000,1000,1000,0
20816,2012,Autumn,8/7/2012,1344 BEECH n/a City of Louisville KY 40211,Structure Fire,111,111 - Building fire,100,0,100,675000,674900
20843,2012,Autumn,8/7/2012,S 25TH City of Louisville KY 40210,Vehicle Fire,131,131 - Passenger vehicle fire,0,1000,1000,2500,1500
20889,2012,Autumn,8/8/2012,3747 PENWAY n/a City of Louisville KY 40211,Vehicle Fire,131,131 - Passenger vehicle fire,0,2000,2000,2000,0
20891,2012,Autumn,8/8/2012,1009 DRESDEN n/a City of Louisville KY 40215,Structure Fire,111,111 - Building fire,0,2000,2000,10000,8000
20893,2012,Autumn,8/8/2012,1930 OLIVE Laundry City of Louisville KY 40210,Structure Fire,111,111 - Building fire,100,500,600,500,-100
20959,2012,Autumn,8/8/2012,4307 ELLIOTT n/a City of Louisville KY 40211,Structure Fire,111,111 - Building fire,0,200,200,99990,99790
21006,2012,Autumn,8/9/2012,3027 GREENWOOD 000A City of Louisville KY 40211,Structure Fire,111,111 - Building fire,500,1000,1500,90000,88500
21156,2012,Autumn,8/10/2012,SOUTHERN City of Louisville KY 40214,Vehicle Fire,131,131 - Passenger vehicle fire,0,1500,1500,8000,6500
21209,2012,Autumn,8/11/2012,S 4TH City of Louisville KY 40208,Structure Fire,113,"113 - Cooking fire, confined to container",0,400,400,1000000,999600
21251,2012,Autumn,8/12/2012,232 N CAMPBELL N/A City of Louisville KY 40206,Outside Fire,151,"151 - Outside rubbish, trash or waste fire",250,250,500,250,-250
21292,2012,Autumn,8/12/2012,446 N 26TH 1 thru 4 City of Louisville KY 40212,Outside Fire,160,"160 - Special outside fire, other",30,0,30,0,-30
21303,2012,Autumn,8/12/2012,2013 ROWAN N/A City of Louisville KY 40203,Structure Fire,112,112 - Fires in structure other than in a building,0,500,500,500,0
21306,2012,Autumn,8/12/2012,2530 ROWAN N/A City of Louisville KY 40212,Structure Fire,111,111 - Building fire,250,3000,3250,80000,76750
21303,2012,Autumn,8/12/2012,2013 ROWAN N/A City of Louisville KY 40203,Structure Fire,111,111 - Building fire,0,5000,5000,65000,60000
21303,2012,Autumn,8/12/2012,2015 ROWAN N/A City of Louisville KY 40203,Structure Fire,111,111 - Building fire,0,15000,15000,50000,35000
21358,2012,Autumn,8/13/2012,1000 E MUHAMMAD ALI N/A City of Louisville KY 40204,Structure Fire,111,111 - Building fire,10000,15000,25000,38000,13000
21405,2012,Autumn,8/13/2012,700 DOUGLAS n/a City of Louisville KY 40214,Outside Fire,151,"151 - Outside rubbish, trash or waste fire",0,300,300,300,0
21458,2012,Autumn,8/14/2012,1780 I 264 East N/A City of Cambridge KY 40220,Vehicle Fire,132,132 - Road freight or transport vehicle fire,0,300,300,300,0
21500,2012,Autumn,8/14/2012,16 HIGHWOOD none City of Louisville KY 40206,Structure Fire,113,"113 - Cooking fire, confined to container",250,1000,1250,300000,298750
21533,2012,Autumn,8/15/2012,2920 BANK None City of Louisville KY 40212,Structure Fire,111,111 - Building fire,0,10000,10000,22500,12500
21599,2012,Autumn,8/15/2012,538 E ORMSBY n/a City of Louisville KY 40203,Structure Fire,111,111 - Building fire,2000,25000,27000,60000,33000
21631,2012,Autumn,8/16/2012,N BROOK City of Louisville KY 40202,Vehicle Fire,131,131 - Passenger vehicle fire,200,1500,1700,1500,-200
21672,2012,Autumn,8/16/2012,2929 GARLAND N/A City of Louisville KY 40211,Vehicle Fire,138,138 - Off-road vehicle or heavy equipment fire,0,10000,10000,10000,0
21729,2012,Autumn,8/17/2012,3202 FRANKFORT n/a City of Louisville KY 40206,Structure Fire,111,111 - Building fire,0,50,50,200000,199950
21864,2012,Autumn,8/18/2012,2001 NEWBURG n/a City of Kingsley KY 40205,Vehicle Fire,131,131 - Passenger vehicle fire,200,1500,1700,1500,-200
21935,2012,Autumn,8/19/2012,1525 CLARA N/A City of Louisville KY 40215,Vehicle Fire,131,131 - Passenger vehicle fire,0,3000,3000,3000,0
21950,2012,Autumn,8/19/2012,1747 W GAULBERT n/a City of Louisville KY 40210,Vehicle Fire,131,131 - Passenger vehicle fire,0,12000,12000,12000,0
21987,2012,Autumn,8/19/2012,4104 LAURELWOOD n/a City of Cambridge KY 40220,Outside Fire,160,"160 - Special outside fire, other",0,500,500,1500,1000
22003,2012,Autumn,8/19/2012,301 ROCK CLIFF 5 City of Louisville KY 40218,Structure Fire,111,111 - Building fire,0,1500,1500,2500,1000
22057,2012,Autumn,8/20/2012,DIXIE City of Louisville KY 40210,Vehicle Fire,131,131 - Passenger vehicle fire,200,31500,31700,31500,-200
22112,2012,Autumn,8/20/2012,206 ROCK CLIFF 206 City of Louisville KY 40218,Structure Fire,111,111 - Building fire,0,1000,1000,250000,249000
22115,2012,Autumn,8/20/2012,937 PHILLIPS n/a City of Louisville KY 40209,Vehicle Fire,131,131 - Passenger vehicle fire,500,2000,2500,3500,1000
22121,2012,Autumn,8/20/2012,3320 PRESTON NA City of Audubon Park KY 40213,Vehicle Fire,131,131 - Passenger vehicle fire,0,2500,2500,4000,1500
22143,2012,Autumn,8/21/2012,2151 GOLDSMITH 25 City of Louisville KY 40218,Structure Fire,111,111 - Building fire,0,300,300,250000,249700
22149,2012,Autumn,8/21/2012,2311 S 36TH N/A City of Louisville KY 40211,Structure Fire,111,111 - Building fire,500,1500,2000,35000,33000
22273,2012,Autumn,8/22/2012,3408 DR WILLIAM G WEATHERS N/A City of Louisville KY 40211,Vehicle Fire,131,131 - Passenger vehicle fire,0,2000,2000,2000,0
22280,2012,Autumn,8/22/2012,461 HURON n/a City of Louisville KY 40209,Vehicle Fire,131,131 - Passenger vehicle fire,0,3000,3000,3000,0
22306,2012,Autumn,8/22/2012,1200 MAPLE Print Rag Bay City of Louisville KY 40210,Structure Fire,118,"118 - Trash or rubbish fire, contained",200,0,200,0,-200
22280,2012,Autumn,8/22/2012,461 HURON n/a City of Louisville KY 40209,Vehicle Fire,131,131 - Passenger vehicle fire,0,3000,3000,3000,0
22416,2012,Autumn,8/24/2012,1712 MAE STREET KIDD na City of Louisville KY 40211,Vehicle Fire,131,131 - Passenger vehicle fire,500,2000,2500,2000,-500
22459,2012,Autumn,8/24/2012,N 17TH City of Louisville KY 40203,Vehicle Fire,131,131 - Passenger vehicle fire,0,1000,1000,1000,0
22489,2012,Autumn,8/24/2012,2317 WILSON na City of Louisville KY 40210,Structure Fire,111,111 - Building fire,2000,8000,10000,8000,-2000
22489,2012,Autumn,8/24/2012,2317 WILSON na City of Louisville KY 40210,Structure Fire,111,111 - Building fire,0,3000,3000,3000,0
22513,2012,Autumn,8/25/2012,2127 PORTLAND n/a City of Louisville KY 40212,Structure Fire,111,111 - Building fire,15000,50000,65000,70000,5000
22534,2012,Autumn,8/25/2012,1010 S 32ND na City of Louisville KY 40211,Structure Fire,111,111 - Building fire,10000,15000,25000,80000,55000
22537,2012,Autumn,8/25/2012,225 ABRAHAM FLEXNER 1st floor City of Louisville KY 40202,Structure Fire,111,111 - Building fire,5000,5000,10000,3000000,2990000
22588,2012,Autumn,8/25/2012,4905 GRANT n/a City of Louisville KY 40214,Structure Fire,118,"118 - Trash or rubbish fire, contained",1000,0,1000,0,-1000
22592,2012,Autumn,8/25/2012,WILSON City of Louisville KY 40211,Vehicle Fire,131,131 - Passenger vehicle fire,0,3000,3000,3000,0
22607,2012,Autumn,8/26/2012,117 S 40TH n/a City of Louisville KY 40212,Structure Fire,111,111 - Building fire,500,5000,5500,5000,-500
22619,2012,Autumn,8/26/2012,4919 WABASH n/a City of Louisville KY 40214,Vehicle Fire,131,131 - Passenger vehicle fire,0,5000,5000,5000,0
22660,2012,Autumn,8/26/2012,13581 I 65 North n/a City of Louisville KY 40202,Vehicle Fire,131,131 - Passenger vehicle fire,100,5000,5100,5000,-100
22719,2012,Autumn,8/27/2012,3025 HIKES N/A City of Cambridge KY 40220,Vehicle Fire,131,131 - Passenger vehicle fire,500,3500,4000,4000,0
22733,2012,Autumn,8/27/2012,10 I 71 South N/A City of Louisville KY 40206,Vehicle Fire,132,132 - Road freight or transport vehicle fire,0,1000,1000,375000,374000
22735,2012,Autumn,8/27/2012,2710 GREENWOOD na City of Louisville KY 40211,Structure Fire,111,111 - Building fire,5000,25000,30000,25000,-5000
22870,2012,Autumn,8/28/2012,849 S 26TH N/A City of Louisville KY 40211,Structure Fire,111,111 - Building fire,0,15000,15000,45000,30000
22898,2012,Autumn,8/29/2012,2202 BOLLING N/a City of Louisville KY 40210,Vehicle Fire,131,131 - Passenger vehicle fire,0,3000,3000,3000,0
22937,2012,Autumn,8/29/2012,916 ASH N/A City of Louisville KY 40217,Outside Fire,151,"151 - Outside rubbish, trash or waste fire",0,500,500,120000,119500
22942,2012,Autumn,8/29/2012,206 BULLITT N/A City of Bancroft KY 40222,Structure Fire,111,111 - Building fire,1000,4000,5000,920000,915000
22961,2012,Autumn,8/29/2012,3725 PENWAY na City of Louisville KY 40211,Structure Fire,111,111 - Building fire,3000,15000,18000,15000,-3000
22985,2012,Autumn,8/30/2012,2519 MONTGOMERY n/a City of Louisville KY 40212,Structure Fire,113,"113 - Cooking fire, confined to container",200,0,200,0,-200
23150,2012,Autumn,8/31/2012,3220 KIRBY n/a City of Louisville KY 40211,Structure Fire,111,111 - Building fire,2000,10000,12000,65000,53000
23453,2012,Autumn,9/3/2012,3653 Taylor N/A City of Louisville KY 40215,Vehicle Fire,131,131 - Passenger vehicle fire,0,1000,1000,1000,0
23486,2012,Autumn,9/3/2012,LOUISVILLE City of Louisville KY 40209,Vehicle Fire,131,131 - Passenger vehicle fire,0,1000,1000,7000,6000
23487,2012,Autumn,9/3/2012,3118 RADIANCE N/A City of Cambridge KY 40220,Vehicle Fire,131,131 - Passenger vehicle fire,0,2000,2000,3000,1000
23561,2012,Autumn,9/4/2012,508 DAKOTA n/a City of Louisville KY 40209,Structure Fire,111,111 - Building fire,75000,250000,325000,250000,-75000
23574,2012,Autumn,9/4/2012,584 VILLAGE WEST N/A City of Louisville KY 40203,Structure Fire,111,111 - Building fire,0,2000,2000,100000,98000
23757,2012,Autumn,9/6/2012,800 W CHESTNUT N/A City of Louisville KY 40203,Vehicle Fire,131,131 - Passenger vehicle fire,0,825,825,825,0
23935,2012,Autumn,9/7/2012,240 I 71 North N/A City of Beechwood Village KY 40207,Vehicle Fire,131,131 - Passenger vehicle fire,250,5000,5250,5000,-250
23939,2012,Autumn,9/7/2012,2417 ELLIOTT n/a City of Louisville KY 40211,Structure Fire,111,111 - Building fire,5000,55000,60000,75000,15000
24149,2012,Autumn,9/9/2012,516 S 18TH N/A City of Louisville KY 40203,Structure Fire,111,111 - Building fire,15000,40000,55000,80000,25000
24184,2012,Autumn,9/10/2012,1413 SOUTHGATE N/A City of Louisville KY 40215,Outside Fire,160,"160 - Special outside fire, other",0,200,200,1200,1000
24258,2012,Autumn,9/10/2012,1487 FRANKFORT N/A City of Louisville KY 40206,Vehicle Fire,131,131 - Passenger vehicle fire,1000,6000,7000,6000,-1000
24258,2012,Autumn,9/10/2012,1487 FRANKFORT N/A City of Louisville KY 40206,Vehicle Fire,131,131 - Passenger vehicle fire,0,1000,1000,3000,2000
24278,2012,Autumn,9/11/2012,2708 SLEVIN n/a City of Louisville KY 40212,Structure Fire,111,111 - Building fire,0,28170,28170,28170,0
24278,2012,Autumn,9/11/2012,2706 SLEVIN n/a City of Louisville KY 40212,Structure Fire,111,111 - Building fire,0,10000,10000,34190,24190
24278,2012,Autumn,9/11/2012,2710 SLEVIN n/a City of Louisville KY 40212,Structure Fire,111,111 - Building fire,0,12000,12000,36540,24540
24495,2012,Autumn,9/13/2012,1810 S 24TH na City of Louisville KY 40210,Vehicle Fire,131,131 - Passenger vehicle fire,0,500,500,2000,1500
24714,2012,Autumn,9/15/2012,2501 CRITTENDEN 0 City of Louisville KY 40217,Vehicle Fire,131,131 - Passenger vehicle fire,0,2000,2000,2000,0
24800,2012,Autumn,9/16/2012,624 N 26TH na City of Louisville KY 40212,Vehicle Fire,131,131 - Passenger vehicle fire,0,600,600,600,0
24821,2012,Autumn,9/16/2012,790 I 64 East N/A City of Louisville KY 40206,Vehicle Fire,131,131 - Passenger vehicle fire,0,300,300,300,0
24839,2012,Autumn,9/16/2012,923 SHELBY n/a City of Louisville KY 40204,Structure Fire,111,111 - Building fire,500,2000,2500,10000,7500
24980,2012,Autumn,9/18/2012,3675 KAHLERT N/A City of Louisville KY 40215,Structure Fire,111,111 - Building fire,5000,15000,20000,65540,45540
24982,2012,Autumn,9/18/2012,S 3RD City of Louisville KY 40202,Vehicle Fire,131,131 - Passenger vehicle fire,0,400,400,3200,2800
24994,2012,Autumn,9/18/2012,5366 NEW CUT n/a City of Louisville KY 40214,Structure Fire,111,111 - Building fire,0,1000,1000,100000,99000
25188,2012,Autumn,9/20/2012,322 LOUIS COLEMAN JR 4 City of Louisville KY 40212,Structure Fire,111,111 - Building fire,1000,5000,6000,75000,69000
25313,2012,Autumn,9/21/2012,937 PHILLIPS N/A City of Louisville KY 40209,Vehicle Fire,138,138 - Off-road vehicle or heavy equipment fire,1200,0,1200,0,-1200
25340,2012,Autumn,9/22/2012,4700 W BROADWAY n/a City of Louisville KY 40211,Vehicle Fire,131,131 - Passenger vehicle fire,0,3000,3000,3000,0
25398,2012,Autumn,9/22/2012,556 VILLAGE WEST NA City of Louisville KY 40203,Structure Fire,111,111 - Building fire,200,0,200,0,-200
25424,2012,Autumn,9/23/2012,OWEN City of Louisville KY 40212,Vehicle Fire,131,131 - Passenger vehicle fire,300,6500,6800,6500,-300
25483,2012,Autumn,9/23/2012,S 33RD City of Louisville KY 40211,Vehicle Fire,131,131 - Passenger vehicle fire,200,1500,1700,3000,1300
25492,2012,Autumn,9/23/2012,2622 W BROADWAY n/a City of Louisville KY 40211,Structure Fire,111,111 - Building fire,100,100,200,100000,99800
25529,2012,Autumn,9/24/2012,S 7TH City of Louisville KY 40202,Vehicle Fire,131,131 - Passenger vehicle fire,0,1500,1500,1500,0
25548,2012,Autumn,9/24/2012,SOUTHERN City of Louisville KY 40214,Vehicle Fire,131,131 - Passenger vehicle fire,0,1000,1000,1000,0
25597,2012,Autumn,9/24/2012,452 DOUGLAS n/a City of Louisville KY 40214,Vehicle Fire,131,131 - Passenger vehicle fire,0,1000,1000,1000,0
25597,2012,Autumn,9/24/2012,452 DOUGLAS n/a City of Louisville KY 40214,Vehicle Fire,131,131 - Passenger vehicle fire,0,1000,1000,1000,0
25597,2012,Autumn,9/24/2012,452 DOUGLAS n/a City of Louisville KY 40214,Vehicle Fire,131,131 - Passenger vehicle fire,0,1000,1000,1000,0
25668,2012,Autumn,9/25/2012,1521 W JEFFERSON N/a City of Louisville KY 40203,Vehicle Fire,131,131 - Passenger vehicle fire,0,3000,3000,3000,0
26017,2012,Autumn,9/29/2012,430 I 64 East n/a City of Louisville KY 40202,Vehicle Fire,131,131 - Passenger vehicle fire,0,2000,2000,10000,8000
26032,2012,Autumn,9/29/2012,815 W MARKET 708 City of Louisville KY 40202,Structure Fire,118,"118 - Trash or rubbish fire, contained",1000,1000,2000,1000,-1000
26152,2012,Autumn,10/1/2012,1544 S 30TH n/a City of Louisville KY 40211,Structure Fire,111,111 - Building fire,0,2500,2500,40000,37500
26377,2012,Autumn,10/3/2012,313 MAC BRAE n/a City of Louisville KY 40214,Vehicle Fire,131,131 - Passenger vehicle fire,0,1000,1000,4000,3000
26604,2012,Autumn,10/5/2012,2223 ST XAVIER N/A City of Louisville KY 40212,Structure Fire,111,111 - Building fire,5000,22400,27400,22400,-5000
26604,2012,Autumn,10/5/2012,2221 ST XAVIER N/A City of Louisville KY 40212,Structure Fire,111,111 - Building fire,15000,20000,35000,40000,5000
26604,2012,Autumn,10/5/2012,2225 ST XAVIER N/A City of Louisville KY 40212,Structure Fire,111,111 - Building fire,0,3000,3000,40000,37000
26642,2012,Autumn,10/6/2012,2223 GOLDSMITH n/a City of Louisville KY 40218,Structure Fire,111,111 - Building fire,0,50000,50000,150000,100000
26703,2012,Autumn,10/7/2012,4904 PRESTON 0 City of Audubon Park KY 40213,Structure Fire,111,111 - Building fire,25000,50000,75000,50000,-25000
26723,2012,Autumn,10/7/2012,1900 SILS n/a City of Kingsley KY 40205,Structure Fire,111,111 - Building fire,0,12000,12000,400000,388000
26782,2012,Autumn,10/8/2012,1311 S 2ND n/a City of Louisville KY 40208,Structure Fire,111,111 - Building fire,2500,10000,12500,250000,237500
26818,2012,Autumn,10/8/2012,2714 7TH STREET 35 City of Louisville KY 40215,Structure Fire,121,121 - Fire in mobile home used as fixed residence,15000,30000,45000,30000,-15000
26890,2012,Autumn,10/9/2012,1520 LINCOLN n/a City of Audubon Park KY 40213,Structure Fire,111,111 - Building fire,10000,20000,30000,80000,50000
26920,2012,Autumn,10/9/2012,210 S 43RD kitchen City of Louisville KY 40212,Structure Fire,113,"113 - Cooking fire, confined to container",0,100,100,100,0
26938,2012,Autumn,10/9/2012,RESERVOIR City of Louisville KY 40206,Vehicle Fire,131,131 - Passenger vehicle fire,0,5000,5000,5000,0
26986,2012,Autumn,10/10/2012,2514 S 4TH 1 City of Louisville KY 40208,Structure Fire,111,111 - Building fire,0,300,300,100000,99700
27048,2012,Autumn,10/10/2012,108 N RASTETTER N/A City of Louisville KY 40206,Structure Fire,112,112 - Fires in structure other than in a building,0,5000,5000,5000,0
27128,2012,Autumn,10/11/2012,1438 SHINGO na City of Louisville KY 40215,Vehicle Fire,131,131 - Passenger vehicle fire,500,2000,2500,2000,-500
27149,2012,Autumn,10/11/2012,163 BRECKINRIDGE 15 City of Cambridge KY 40220,Vehicle Fire,131,131 - Passenger vehicle fire,0,3000,3000,3000,0
27289,2012,Autumn,10/13/2012,2009 TERRIL 24 City of Louisville KY 40218,Structure Fire,111,111 - Building fire,10000,20000,30000,466000,436000
27472,2012,Autumn,10/15/2012,2739 BROWNSBORO 8 City of Louisville KY 40206,Structure Fire,111,111 - Building fire,25000,40000,65000,342000,277000
27535,2012,Autumn,10/15/2012,1718 ODANIEL 6 City of Audubon Park KY 40213,Structure Fire,111,111 - Building fire,500,1000,1500,40000,38500
27585,2012,Autumn,10/16/2012,428 N 41ST N/A City of Louisville KY 40212,Outside Fire,151,"151 - Outside rubbish, trash or waste fire",0,2000,2000,75210,73210
27717,2012,Autumn,10/18/2012,1324 OLIVE 1 City of Louisville KY 40211,Structure Fire,111,111 - Building fire,0,40000,40000,40000,0
27717,2012,Autumn,10/18/2012,1328 OLIVE 1 City of Louisville KY 40211,Structure Fire,111,111 - Building fire,1000,3500,4500,35000,30500
27717,2012,Autumn,10/18/2012,1322 OLIVE 1 City of Louisville KY 40211,Structure Fire,111,111 - Building fire,2500,25000,27500,40000,12500
27851,2012,Autumn,10/19/2012,1832 DIXDALE N/A City of Louisville KY 40210,Structure Fire,113,"113 - Cooking fire, confined to container",200,0,200,0,-200
27866,2012,Autumn,10/19/2012,1721 LYTLE n/a City of Louisville KY 40203,Structure Fire,111,111 - Building fire,1000,20000,21000,30000,9000
27866,2012,Autumn,10/19/2012,1723 LYTLE n/a City of Louisville KY 40203,Structure Fire,111,111 - Building fire,0,500,500,30000,29500
27943,2012,Autumn,10/20/2012,3006 PENWAY N/A City of Louisville KY 40210,Structure Fire,118,"118 - Trash or rubbish fire, contained",100,800,900,70000,69100
28060,2012,Autumn,10/21/2012,1900 STRATHMOOR N/A City of Kingsley KY 40205,Outside Fire,162,162 - Outside equipment fire,0,500,500,150000,149500
28258,2012,Autumn,10/23/2012,821 S JACKSON n/a City of Louisville KY 40203,Outside Fire,151,"151 - Outside rubbish, trash or waste fire",0,1000,1000,45000,44000
28310,2012,Autumn,10/24/2012,S 4TH City of Louisville KY 40208,Vehicle Fire,131,131 - Passenger vehicle fire,0,1000,1000,1000,0
28358,2012,Autumn,10/24/2012,1430 ARLING n/a City of Louisville KY 40215,Vehicle Fire,131,131 - Passenger vehicle fire,0,1000,1000,7000,6000
28367,2012,Autumn,10/24/2012,1943 NEWBURG 2 City of Kingsley KY 40205,Structure Fire,113,"113 - Cooking fire, confined to container",300,0,300,0,-300
28394,2012,Autumn,10/25/2012,605 LYNN n/a City of Louisville KY 40217,Outside Fire,160,"160 - Special outside fire, other",500,2000,2500,2000,-500
28540,2012,Autumn,10/26/2012,2201 W MAIN na City of Louisville KY 40212,Structure Fire,111,111 - Building fire,3000,0,3000,0,-3000
28594,2012,Autumn,10/27/2012,BARDSTOWN City of Kingsley KY 40205,Vehicle Fire,131,131 - Passenger vehicle fire,1500,0,1500,0,-1500
28692,2012,Autumn,10/29/2012,3923 BANK n/a City of Louisville KY 40212,Structure Fire,111,111 - Building fire,1000,0,1000,0,-1000
28707,2012,Autumn,10/29/2012,4036 POPLAR LEVEL n/a City of Audubon Park KY 40213,Structure Fire,111,111 - Building fire,45000,45000,90000,100000,10000
28788,2012,Autumn,10/30/2012,1546 GALLAGHER n/a City of Louisville KY 40210,Structure Fire,112,112 - Fires in structure other than in a building,500,500,1000,15000,14000
28854,2012,Autumn,10/30/2012,3241 GOLDEN TURTLE 102 City of Louisville KY 40218,Structure Fire,111,111 - Building fire,2000,5000,7000,400000,393000
28902,2012,Autumn,10/31/2012,4705 BELLEVUE Bldg. A City of Louisville KY 40215,Outside Fire,150,"150 - Outside rubbish fire, other",0,5000,5000,20000,15000
28954,2012,Autumn,10/31/2012,1425 S 28TH N/A City of Louisville KY 40211,Vehicle Fire,131,131 - Passenger vehicle fire,0,11000,11000,11000,0
29052,2012,Winter,11/2/2012,415 MAC BRAE n/a City of Louisville KY 40214,Structure Fire,113,"113 - Cooking fire, confined to container",1000,1000,2000,110000,108000
29073,2012,Winter,11/2/2012,1629 S 3RD n/a City of Louisville KY 40208,Structure Fire,111,111 - Building fire,0,100,100,300000,299900
29092,2012,Winter,11/2/2012,2827 HALE n/a City of Louisville KY 40211,Structure Fire,111,111 - Building fire,6000,0,6000,0,-6000
29093,2012,Winter,11/2/2012,3715 BRIARBRIDGE N/A City of Louisville KY 40218,Vehicle Fire,131,131 - Passenger vehicle fire,0,300,300,900,600
29115,2012,Winter,11/2/2012,109 N 43RD N/A City of Louisville KY 40212,Structure Fire,111,111 - Building fire,0,20000,20000,42000,22000
29210,2012,Winter,11/4/2012,3001 LINWOOD N/A City of Louisville KY 40210,Structure Fire,113,"113 - Cooking fire, confined to container",200,300,500,70000,69500
29243,2012,Winter,11/4/2012,1137 S 32ND na City of Louisville KY 40211,Structure Fire,111,111 - Building fire,100,0,100,0,-100
29253,2012,Winter,11/4/2012,4501 S 6TH 39 City of Louisville KY 40214,Structure Fire,111,111 - Building fire,2000,500,2500,27000,24500
29342,2012,Winter,11/5/2012,2614 ALGONQUIN na City of Louisville KY 40210,Structure Fire,111,111 - Building fire,1000,2000,3000,80000,77000
29376,2012,Winter,11/5/2012,223 NORTHWESTERN N/A City of Louisville KY 40212,Structure Fire,111,111 - Building fire,12000,65000,77000,85000,8000
29376,2012,Winter,11/5/2012,221 NORTHWESTERN N/A City of Louisville KY 40212,Structure Fire,111,111 - Building fire,250,1000,1250,100000,98750
29422,2012,Winter,11/6/2012,214 E ORMSBY 2 City of Louisville KY 40203,Structure Fire,111,111 - Building fire,500,10000,10500,215000,204500
29433,2012,Winter,11/6/2012,1730 W ST CATHERINE 1 City of Louisville KY 40210,Structure Fire,111,111 - Building fire,0,500,500,20000,19500
29439,2012,Winter,11/6/2012,214 E ORMSBY 2 City of Louisville KY 40203,Structure Fire,118,"118 - Trash or rubbish fire, contained",0,200,200,300000,299800
29443,2012,Winter,11/6/2012,1908 RUSSELL LEE N/A City of Louisville KY 40211,Vehicle Fire,131,131 - Passenger vehicle fire,0,500,500,4000,3500
29452,2012,Winter,11/6/2012,4716 S 1ST na City of Louisville KY 40214,Structure Fire,111,111 - Building fire,500,1000,1500,50000,48500
29489,2012,Winter,11/7/2012,922 JONES na City of Louisville KY 40214,Structure Fire,111,111 - Building fire,10000,20000,30000,20000,-10000
29510,2012,Winter,11/7/2012,7329 PAIUTE basement City of Louisville KY 40214,Structure Fire,111,111 - Building fire,20000,40000,60000,140000,80000
29551,2012,Winter,11/7/2012,501 W Florence 0 City of Louisville KY 40214,Vehicle Fire,131,131 - Passenger vehicle fire,0,3000,3000,3000,0
29613,2012,Winter,11/8/2012,1041 W WHITNEY n/a City of Louisville KY 40215,Vehicle Fire,131,131 - Passenger vehicle fire,0,1000,1000,10000,9000
29635,2012,Winter,11/8/2012,340 I 264 East N/A City of Louisville KY 40211,Vehicle Fire,131,131 - Passenger vehicle fire,0,3000,3000,4000,1000
29683,2012,Winter,11/9/2012,1228 HULL N/A City of Louisville KY 40204,Vehicle Fire,131,131 - Passenger vehicle fire,500,8000,8500,8000,-500
29689,2012,Winter,11/9/2012,1334 CYPRESS N/A City of Louisville KY 40211,Structure Fire,111,111 - Building fire,0,100,100,28500,28400
29764,2012,Winter,11/10/2012,501 W FLORENCE n/a City of Louisville KY 40215,Structure Fire,111,111 - Building fire,20000,30000,50000,140000,90000
29806,2012,Winter,11/10/2012,3201 LEITH n/a City of Louisville KY 40218,Vehicle Fire,131,131 - Passenger vehicle fire,0,5000,5000,5000,0
29854,2012,Winter,11/11/2012,1570 S 7TH n/a City of Louisville KY 40208,Outside Fire,154,154 - Dumpster or other outside trash receptacle fire,0,1000,1000,100000,99000
29868,2012,Winter,11/11/2012,2916 VIRGINIA na City of Louisville KY 40211,Structure Fire,111,111 - Building fire,5000,15000,20000,60000,40000
29875,2012,Winter,11/11/2012,1725 W Kentucky N/A City of Louisville KY 40210,Structure Fire,111,111 - Building fire,0,6000,6000,6000,0
29902,2012,Winter,11/11/2012,627 S 43RD n/a City of Louisville KY 40211,Structure Fire,111,111 - Building fire,10000,15000,25000,125000,100000
29908,2012,Winter,11/11/2012,1412 THORNBERRY 0 City of Louisville KY 40215,Outside Fire,160,"160 - Special outside fire, other",0,200,200,2000,1800
29918,2012,Winter,11/11/2012,4031 CHURCHMAN NA City of Louisville KY 40215,Vehicle Fire,131,131 - Passenger vehicle fire,50,1000,1050,6000,4950
30014,2012,Winter,11/13/2012,734 S 36TH N/A City of Louisville KY 40211,Structure Fire,111,111 - Building fire,2000,3000,5000,36100,31100
30020,2012,Winter,11/13/2012,1501 HEMLOCK N/A City of Louisville KY 40211,Structure Fire,111,111 - Building fire,2000,3000,5000,3000,-2000
30072,2012,Winter,11/13/2012,3912 W BROADWAY n/a City of Louisville KY 40211,Outside Fire,162,162 - Outside equipment fire,0,1000,1000,1000,0
30083,2012,Winter,11/13/2012,S 3RD City of Louisville KY 40208,Vehicle Fire,131,131 - Passenger vehicle fire,0,1000,1000,1000,0
30020,2012,Winter,11/13/2012,1501 HEMLOCK N/A City of Louisville KY 40211,Structure Fire,111,111 - Building fire,0,2000,2000,2000,0
30118,2012,Winter,11/14/2012,815 S 24TH N/A City of Louisville KY 40211,Structure Fire,111,111 - Building fire,20000,50000,70000,85000,15000
30146,2012,Winter,11/14/2012,427 S CAMPBELL N/A City of Louisville KY 40204,Structure Fire,111,111 - Building fire,100000,200000,300000,614080,314080
30199,2012,Winter,11/15/2012,801 E WITHERSPOON N/A City of Louisville KY 40202,Structure Fire,111,111 - Building fire,500,1000,1500,876500,875000
30200,2012,Winter,11/15/2012,W MARKET City of Louisville KY 40212,Vehicle Fire,131,131 - Passenger vehicle fire,0,1000,1000,2000,1000
30207,2012,Winter,11/15/2012,410 S 26TH N/A City of Louisville KY 40212,Structure Fire,111,111 - Building fire,0,10000,10000,21070,11070
30217,2012,Winter,11/15/2012,2817 SMILAX n/a City of Audubon Park KY 40213,Structure Fire,111,111 - Building fire,0,1000,1000,60000,59000
30260,2012,Winter,11/15/2012,3228 RIVER PARK na City of Louisville KY 40211,Vehicle Fire,131,131 - Passenger vehicle fire,0,2200,2200,2200,0
30266,2012,Winter,11/15/2012,1354 BERRY n/a City of Louisville KY 40215,Vehicle Fire,131,131 - Passenger vehicle fire,250,500,750,1000,250
30207,2012,Winter,11/15/2012,412 S 26TH N/A City of Louisville KY 40212,Structure Fire,111,111 - Building fire,0,200,200,31640,31440
30207,2012,Winter,11/15/2012,408 S 26TH N/A City of Louisville KY 40212,Structure Fire,111,111 - Building fire,0,200,200,25010,24810
30285,2012,Winter,11/16/2012,S 27TH City of Louisville KY 40211,Vehicle Fire,131,131 - Passenger vehicle fire,0,100,100,500,400
30328,2012,Winter,11/16/2012,1520 LARCHMONT N/A City of Louisville KY 40215,Structure Fire,111,111 - Building fire,2000,8000,10000,150000,140000
30375,2012,Winter,11/16/2012,1511 BEECH n/a City of Louisville KY 40211,Structure Fire,111,111 - Building fire,0,20000,20000,50480,30480
30382,2012,Winter,11/17/2012,713 CREEL na City of Louisville KY 40208,Structure Fire,111,111 - Building fire,2000,10000,12000,80000,68000
30414,2012,Winter,11/17/2012,2455 BARDSTOWN N/A City of Kingsley KY 40205,Structure Fire,111,111 - Building fire,200000,20000,220000,1500000,1280000
30455,2012,Winter,11/17/2012,2821 PINDELL n/a City of Louisville KY 40217,Vehicle Fire,131,131 - Passenger vehicle fire,1000,8000,9000,8000,-1000
30556,2012,Winter,11/19/2012,13080 I 65 South n/a City of Louisville KY 40209,Vehicle Fire,131,131 - Passenger vehicle fire,100,4000,4100,4000,-100
30628,2012,Winter,11/19/2012,317 N 38TH N/A City of Louisville KY 40212,FALSE,162,162 - Outside equipment fire,1000,0,1000,NULL,NULL
30632,2012,Winter,11/19/2012,211 W BURNETT n/a City of Louisville KY 40208,Structure Fire,111,111 - Building fire,0,2000,2000,250000,248000
30743,2012,Winter,11/20/2012,1431 PHYLLIS 0 City of Louisville KY 40215,Vehicle Fire,131,131 - Passenger vehicle fire,0,5000,5000,5000,0
30808,2012,Winter,11/21/2012,1335 WELLER na City of Louisville KY 40208,Structure Fire,111,111 - Building fire,0,200,200,50000,49800
30831,2012,Winter,11/21/2012,2222 W ORMSBY N/A City of Louisville KY 40210,Structure Fire,112,112 - Fires in structure other than in a building,500,0,500,0,-500
31020,2012,Winter,11/24/2012,2070 EASTERN 1-2-3 City of Louisville KY 40204,Structure Fire,111,111 - Building fire,20000,125000,145000,450000,305000
31091,2012,Winter,11/25/2012,3315 NOE 8 City of Cambridge KY 40220,Structure Fire,111,111 - Building fire,3000,2000,5000,2000,-3000
31095,2012,Winter,11/25/2012,620 S 37TH n/a City of Louisville KY 40211,Vehicle Fire,131,131 - Passenger vehicle fire,0,6600,6600,6600,0
31246,2012,Winter,11/26/2012,603 E OAK n/a City of Louisville KY 40203,Structure Fire,111,111 - Building fire,10000,30000,40000,90000,50000
31246,2012,Winter,11/26/2012,603 E OAK n/a City of Louisville KY 40203,Structure Fire,111,111 - Building fire,5000,10000,15000,53580,38580
31355,2012,Winter,11/28/2012,2511 GRIFFITHS N/A City of Louisville KY 40212,Structure Fire,111,111 - Building fire,2000,5000,7000,20000,13000
31382,2012,Winter,11/28/2012,715 S 38TH n/a City of Louisville KY 40211,Structure Fire,111,111 - Building fire,4000,5000,9000,35000,26000
31477,2012,Winter,11/29/2012,1517 W ORMSBY N/A City of Louisville KY 40210,Vehicle Fire,131,131 - Passenger vehicle fire,500,5000,5500,5000,-500
31541,2012,Winter,11/30/2012,4407 ELLIOTT 11 City of Louisville KY 40211,Structure Fire,111,111 - Building fire,1000,0,1000,0,-1000
31569,2012,Winter,12/1/2012,2808 ROSALEE N/A City of Cambridge KY 40220,Structure Fire,111,111 - Building fire,1000,1000,2000,1000,-1000
31605,2012,Winter,12/1/2012,2065 EASTERN n/a City of Louisville KY 40204,Outside Fire,154,154 - Dumpster or other outside trash receptacle fire,0,20,20,50,30
31693,2012,Winter,12/2/2012,432 DR W J HODGE N/A City of Louisville KY 40203,Structure Fire,111,111 - Building fire,10000,20000,30000,97100,67100
31816,2012,Winter,12/3/2012,1332 S FLOYD n\a City of Louisville KY 40208,Structure Fire,111,111 - Building fire,0,50000,50000,50000,0
31816,2012,Winter,12/3/2012,1334 S FLOYD n\a City of Louisville KY 40208,Structure Fire,111,111 - Building fire,0,2000,2000,41000,39000
31832,2012,Winter,12/4/2012,5002 WABASH n/a City of Louisville KY 40214,Vehicle Fire,131,131 - Passenger vehicle fire,0,2000,2000,4000,2000
31884,2012,Winter,12/4/2012,1040 I 64 West N/A City of Beechwood Village KY 40207,Vehicle Fire,131,131 - Passenger vehicle fire,0,1500,1500,1500,0
31972,2012,Winter,12/5/2012,E WOODLAWN City of Louisville KY 40214,Vehicle Fire,131,131 - Passenger vehicle fire,0,1000,1000,2000,1000
32008,2012,Winter,12/5/2012,216 IROQUOIS n/a City of Louisville KY 40214,Structure Fire,111,111 - Building fire,500,5000,5500,6000,500
32284,2012,Winter,12/8/2012,S FLOYD City of Louisville KY 40203,Structure Fire,111,111 - Building fire,500,2000,2500,150000,147500
32296,2012,Winter,12/8/2012,2214 DUNCAN N/A City of Louisville KY 40212,Structure Fire,111,111 - Building fire,1000,5000,6000,50000,44000
32300,2012,Winter,12/9/2012,730 W WHITNEY 0 City of Louisville KY 40215,Structure Fire,111,111 - Building fire,10000,25000,35000,70000,35000
32327,2012,Winter,12/9/2012,3511 YOUNG N/A City of Louisville KY 40211,Structure Fire,111,111 - Building fire,350,0,350,0,-350
32400,2012,Winter,12/9/2012,WROCKLAGE City of Kingsley KY 40205,Vehicle Fire,131,131 - Passenger vehicle fire,0,1000,1000,4000,3000
32406,2012,Winter,12/9/2012,526 N 29TH n/a City of Louisville KY 40212,Structure Fire,111,111 - Building fire,0,50000,50000,150000,100000
32424,2012,Winter,12/10/2012,2728 W MARKET n/a City of Louisville KY 40212,Structure Fire,111,111 - Building fire,500,1000,1500,100000,98500
32458,2012,Winter,12/10/2012,2342 PAGE n/a City of Kingsley KY 40205,Structure Fire,111,111 - Building fire,800,0,800,0,-800
32547,2012,Winter,12/11/2012,2315 GLENMARY C3 City of Louisville KY 40204,Structure Fire,111,111 - Building fire,5000,10000,15000,117890,102890
32657,2012,Winter,12/12/2012,4218 TAYLOR 1 City of Louisville KY 40215,Vehicle Fire,131,131 - Passenger vehicle fire,100,1000,1100,1000,-100
32664,2012,Winter,12/12/2012,2324 W ORMSBY N/A City of Louisville KY 40210,Structure Fire,111,111 - Building fire,5000,10000,15000,15680,680
32795,2012,Winter,12/14/2012,430 S HANCOCK 101 City of Louisville KY 40202,Structure Fire,113,"113 - Cooking fire, confined to container",500,500,1000,300000,299000
32855,2012,Winter,12/15/2012,4017 LENTZ N/A City of Louisville KY 40215,Structure Fire,111,111 - Building fire,0,500,500,2000,1500
32862,2012,Winter,12/15/2012,1457 S 4TH n/a City of Louisville KY 40208,Outside Fire,151,"151 - Outside rubbish, trash or waste fire",0,450,450,250000,249550
33119,2012,Winter,12/17/2012,517 E KENTUCKY n/a City of Louisville KY 40203,Structure Fire,113,"113 - Cooking fire, confined to container",0,100,100,100,0
33155,2012,Winter,12/18/2012,1421 WURTELE n/a City of Louisville KY 40208,Structure Fire,111,111 - Building fire,300,0,300,0,-300
33292,2012,Winter,12/20/2012,2503 CATAWBA 0 City of Louisville KY 40217,Structure Fire,111,111 - Building fire,2000,5000,7000,45000,38000
33452,2012,Winter,12/21/2012,1054 EUCLID n/a City of Louisville KY 40208,Structure Fire,111,111 - Building fire,0,300,300,70000,69700
33589,2012,Winter,12/22/2012,S 30TH City of Louisville KY 40211,Vehicle Fire,131,131 - Passenger vehicle fire,0,4000,4000,4000,0
33634,2012,Winter,12/23/2012,3586 FINCASTLE n/a City of Audubon Park KY 40213,Vehicle Fire,131,131 - Passenger vehicle fire,200,500,700,500,-200
33676,2012,Winter,12/24/2012,PARTHENIA City of Louisville KY 40215,Vehicle Fire,131,131 - Passenger vehicle fire,0,100,100,8000,7900
33764,2012,Winter,12/25/2012,S 23RD City of Louisville KY 40210,Vehicle Fire,131,131 - Passenger vehicle fire,0,500,500,5000,4500
33860,2012,Winter,12/26/2012,1209 W MUHAMMAD ALI Apt City of Louisville KY 40203,Structure Fire,112,112 - Fires in structure other than in a building,5000,3000,8000,2216000,2208000
33873,2012,Winter,12/26/2012,713 CAMP N/A City of Louisville KY 40203,Structure Fire,111,111 - Building fire,200,3500,3700,3500,-200
33921,2012,Winter,12/26/2012,3535 W MUHAMMAD ALI n/a City of Louisville KY 40212,Structure Fire,111,111 - Building fire,1500,1500,3000,45300,42300
33873,2012,Winter,12/26/2012,710 SHELBY N/A City of Louisville KY 40203,Structure Fire,111,111 - Building fire,0,1000,1000,3000,2000
33873,2012,Winter,12/26/2012,712 SHELBY N/A City of Louisville KY 40203,Structure Fire,111,111 - Building fire,0,1000,1000,5000,4000
33873,2012,Winter,12/26/2012,713 CAMP N/A City of Louisville KY 40203,Structure Fire,111,111 - Building fire,0,1000,1000,40000,39000
33959,2012,Winter,12/27/2012,2818 W MARKET n/a City of Louisville KY 40212,Structure Fire,116,"116 - Fuel burner/boiler malfunction, fire confined",300,300,600,20520,19920
33985,2012,Winter,12/27/2012,521 ZORN G8 City of Louisville KY 40206,Structure Fire,111,111 - Building fire,10000,50000,60000,800000,740000
33990,2012,Winter,12/27/2012,2222 DUNDEE N/A City of Kingsley KY 40205,Structure Fire,111,111 - Building fire,2000,10000,12000,10000,-2000
34032,2012,Winter,12/28/2012,3449 POWELL kitchen City of Louisville KY 40215,Structure Fire,112,112 - Fires in structure other than in a building,0,200,200,200,0
34080,2012,Winter,12/28/2012,1004 BARDSTOWN parking lot City of Louisville KY 40204,Vehicle Fire,131,131 - Passenger vehicle fire,0,1500,1500,1500,0
34167,2012,Winter,12/29/2012,320 S CLAY N/A City of Louisville KY 40202,Structure Fire,113,"113 - Cooking fire, confined to container",400,500,900,300000,299100
34207,2012,Winter,12/30/2012,517 E BRANDEIS N/A City of Louisville KY 40217,Structure Fire,111,111 - Building fire,10000,25000,35000,95000,60000
34225,2012,Winter,12/30/2012,1226 ROWAN N/A City of Louisville KY 40203,Structure Fire,111,111 - Building fire,0,10000,10000,10000,0
34248,2012,Winter,12/30/2012,W SOUTHLAND City of Louisville KY 40214,Vehicle Fire,131,131 - Passenger vehicle fire,0,2500,2500,2500,0
34277,2012,Winter,12/30/2012,2308 OSAGE N/A City of Louisville KY 40210,Structure Fire,111,111 - Building fire,300,700,1000,28880,27880
34338,2012,Winter,12/31/2012,602 RUGGLES 310 City of Louisville KY 40208,Structure Fire,111,111 - Building fire,3000,3000,6000,100000,94000
34380,2012,Winter,12/31/2012,E OAK City of Louisville KY 40203,Vehicle Fire,131,131 - Passenger vehicle fire,0,3000,3000,3000,0
55,2013,Winter,1/1/2013,1237 WELLER 0 City of Louisville KY 40208,Structure Fire,111,111 - Building fire,5000,10000,15000,55000,40000
74,2013,Winter,1/1/2013,S 10TH City of Louisville KY 40203,Vehicle Fire,131,131 - Passenger vehicle fire,0,2500,2500,2500,0
80,2013,Winter,1/1/2013,2312 W KENTUCKY n/a City of Louisville KY 40210,Structure Fire,111,111 - Building fire,0,5000,5000,29000,24000
192,2013,Winter,1/3/2013,302 CHANEL 2 City of Louisville KY 40218,Structure Fire,118,"118 - Trash or rubbish fire, contained",20,0,20,0,-20
227,2013,Winter,1/3/2013,642 LYNN n/a City of Louisville KY 40217,Outside Fire,154,154 - Dumpster or other outside trash receptacle fire,0,50,50,300,250
280,2013,Winter,1/4/2013,HESS City of Louisville KY 40217,Vehicle Fire,131,131 - Passenger vehicle fire,500,5000,5500,10000,4500
342,2013,Winter,1/4/2013,2600 HALE na City of Louisville KY 40211,Structure Fire,111,111 - Building fire,500,100,600,100,-500
441,2013,Winter,1/6/2013,924 S 2ND N/a City of Louisville KY 40203,Vehicle Fire,131,131 - Passenger vehicle fire,0,2000,2000,4000,2000
632,2013,Winter,1/8/2013,1533 BEECH N/A City of Louisville KY 40211,Vehicle Fire,131,131 - Passenger vehicle fire,0,1000,1000,2000,1000
660,2013,Winter,1/8/2013,224 WOODBINE n\a City of Louisville KY 40208,Vehicle Fire,131,131 - Passenger vehicle fire,0,1000,1000,2100,1100
856,2013,Winter,1/10/2013,1244 S 4TH 219 City of Louisville KY 40203,Structure Fire,111,111 - Building fire,500,2000,2500,1000000,997500
865,2013,Winter,1/10/2013,4014 SOUTHERN 1 City of Louisville KY 40214,Structure Fire,111,111 - Building fire,500,1000,1500,50000,48500
1057,2013,Winter,1/12/2013,3122 VIRGINIA N/A City of Louisville KY 40211,Outside Fire,162,162 - Outside equipment fire,0,1000,1000,1000,0
1169,2013,Winter,1/14/2013,7406 PAIUTE na City of Louisville KY 40214,Vehicle Fire,131,131 - Passenger vehicle fire,0,3500,3500,3500,0
1217,2013,Winter,1/14/2013,3532 LENTZ n/a City of Louisville KY 40215,Structure Fire,111,111 - Building fire,2000,5000,7000,15000,8000
1235,2013,Winter,1/14/2013,1200 I 264 East N/A City of Audubon Park KY 40213,Vehicle Fire,131,131 - Passenger vehicle fire,0,250,250,1000,750
1247,2013,Winter,1/14/2013,1714 PATTON B47 City of Louisville KY 40210,Vehicle Fire,131,131 - Passenger vehicle fire,0,4000,4000,4000,0
1531,2013,Winter,1/17/2013,811 S 2ND N/A City of Louisville KY 40203,Vehicle Fire,131,131 - Passenger vehicle fire,0,10000,10000,10000,0
1595,2013,Winter,1/18/2013,1331 MCHENRY n/a City of Louisville KY 40217,Vehicle Fire,131,131 - Passenger vehicle fire,0,1000,1000,2500,1500
1635,2013,Winter,1/18/2013,4304 TAYLOR attic City of Louisville KY 40215,Structure Fire,111,111 - Building fire,5000,20000,25000,160000,135000
1664,2013,Winter,1/19/2013,5330 S 3RD 2nd flr City of Louisville KY 40214,Structure Fire,118,"118 - Trash or rubbish fire, contained",5000,5000,10000,750000,740000
1735,2013,Winter,1/20/2013,1433 BEECH kitchen City of Louisville KY 40211,Structure Fire,113,"113 - Cooking fire, confined to container",0,100,100,140000,139900
1803,2013,Winter,1/20/2013,2704 CLEVELAND N/A City of Louisville KY 40206,Structure Fire,111,111 - Building fire,8000,50000,58000,150000,92000
1804,2013,Winter,1/20/2013,1137 S 32ND N/A City of Louisville KY 40211,Structure Fire,111,111 - Building fire,500,2000,2500,65000,62500
1814,2013,Winter,1/21/2013,630 S 35TH N/A City of Louisville KY 40211,Structure Fire,111,111 - Building fire,2500,25000,27500,40570,13070
1816,2013,Winter,1/21/2013,1714 PATTON B47 City of Louisville KY 40210,Vehicle Fire,131,131 - Passenger vehicle fire,0,5000,5000,5000,0
1929,2013,Winter,1/22/2013,2918 RIO RITA N/A City of Cambridge KY 40220,Structure Fire,111,111 - Building fire,1000,1500,2500,129000,126500
1930,2013,Winter,1/22/2013,332 W BROADWAY second floor City of Louisville KY 40202,Structure Fire,111,111 - Building fire,1000,1000,2000,1000,-1000
2008,2013,Winter,1/23/2013,S 25TH City of Louisville KY 40210,Vehicle Fire,131,131 - Passenger vehicle fire,0,8000,8000,8000,0
2033,2013,Winter,1/23/2013,124 WILLIAM N/A City of Louisville KY 40206,Vehicle Fire,131,131 - Passenger vehicle fire,0,2000,2000,2000,0
2037,2013,Winter,1/23/2013,850 W MUHAMMAD ALI 906 City of Louisville KY 40203,Structure Fire,111,111 - Building fire,0,2000,2000,20000000,19998000
2120,2013,Winter,1/24/2013,1576 S SHELBY n/a City of Louisville KY 40217,Structure Fire,111,111 - Building fire,5000,20000,25000,100000,75000
2132,2013,Winter,1/24/2013,S 28TH City of Louisville KY 40211,Vehicle Fire,131,131 - Passenger vehicle fire,0,1640,1640,1640,0
2162,2013,Winter,1/25/2013,2725 BANK N/A City of Louisville KY 40212,Structure Fire,111,111 - Building fire,10000,30000,40000,38590,-1410
2263,2013,Winter,1/26/2013,2319 PORTLAND n/a City of Louisville KY 40212,Structure Fire,111,111 - Building fire,0,1000,1000,71560,70560
2285,2013,Winter,1/26/2013,S 26TH City of Louisville KY 40211,Vehicle Fire,131,131 - Passenger vehicle fire,0,10000,10000,15000,5000
2471,2013,Winter,1/28/2013,BAXTER City of Louisville KY 40204,Vehicle Fire,131,131 - Passenger vehicle fire,0,3000,3000,5000,2000
2545,2013,Winter,1/29/2013,717 COLORADO n/a City of Louisville KY 40208,Structure Fire,111,111 - Building fire,5000,25000,30000,85000,55000
2560,2013,Winter,1/29/2013,951 CENTRAL n/a City of Louisville KY 40208,Structure Fire,111,111 - Building fire,20,750,770,45870,45100
2590,2013,Winter,1/29/2013,2822 GARFIELD n/a City of Louisville KY 40212,Structure Fire,111,111 - Building fire,1000,2500,3500,29300,25800
2545,2013,Winter,1/29/2013,719 COLORADO n/a City of Louisville KY 40208,Structure Fire,111,111 - Building fire,0,2000,2000,70000,68000
2776,2013,Winter,1/31/2013,S 3RD City of Louisville KY 40208,Vehicle Fire,131,131 - Passenger vehicle fire,0,2000,2000,2000,0
2866,2013,Spring,2/1/2013,4418 TAYLOR 37 City of Louisville KY 40215,Structure Fire,111,111 - Building fire,5000,5000,10000,5000,-5000
2871,2013,Spring,2/1/2013,2503 Grinstead na City of Louisville KY 40204,Vehicle Fire,132,132 - Road freight or transport vehicle fire,0,300,300,300,0
2902,2013,Spring,2/2/2013,104 ALGIERS 3 City of Louisville KY 40218,Structure Fire,111,111 - Building fire,50,100,150,100,-50
2977,2013,Spring,2/2/2013,648 S 43RD na City of Louisville KY 40211,Structure Fire,111,111 - Building fire,0,100,100,30000,29900
3166,2013,Spring,2/5/2013,1405 S 28TH na City of Louisville KY 40211,Structure Fire,111,111 - Building fire,0,12000,12000,45920,33920
3191,2013,Spring,2/5/2013,I 65 South City of Audubon Park KY 40213,Vehicle Fire,131,131 - Passenger vehicle fire,0,1200,1200,1200,0
3288,2013,Spring,2/6/2013,104 OXMOOR N/A City of Bancroft KY 40222,Vehicle Fire,131,131 - Passenger vehicle fire,0,6000,6000,6000,0
3288,2013,Spring,2/6/2013,104 OXMOOR N/A City of Bancroft KY 40222,Vehicle Fire,131,131 - Passenger vehicle fire,0,300,300,5000,4700
3321,2013,Spring,2/7/2013,936 CAMDEN N/A City of Louisville KY 40215,Structure Fire,111,111 - Building fire,2000,5000,7000,25000,18000
3409,2013,Spring,2/7/2013,3501 W KENTUCKY na City of Louisville KY 40211,Vehicle Fire,131,131 - Passenger vehicle fire,0,3200,3200,3200,0
3585,2013,Spring,2/10/2013,1503 BICKNELL n/a City of Louisville KY 40215,Structure Fire,111,111 - Building fire,5000,25000,30000,30000,0
3704,2013,Spring,2/11/2013,1002 SYLVIA N/A City of Louisville KY 40217,Structure Fire,111,111 - Building fire,1000,20000,21000,60000,39000
3726,2013,Spring,2/12/2013,S 36TH City of Louisville KY 40212,Vehicle Fire,131,131 - Passenger vehicle fire,0,200,200,40000,39800
3747,2013,Spring,2/12/2013,2600 W BROADWAY n/a City of Louisville KY 40211,Structure Fire,111,111 - Building fire,500,0,500,100000,99500
3763,2013,Spring,2/12/2013,419 BELGRAVIA None City of Louisville KY 40208,Vehicle Fire,131,131 - Passenger vehicle fire,0,500,500,10000,9500
3803,2013,Spring,2/13/2013,2614 GARLAND N/A City of Louisville KY 40211,Structure Fire,111,111 - Building fire,5000,25000,30000,33000,3000
3803,2013,Spring,2/13/2013,2614 GARLAND N/A City of Louisville KY 40211,Structure Fire,111,111 - Building fire,0,500,500,6000,5500
3803,2013,Spring,2/13/2013,2612 GARLAND N/A City of Louisville KY 40211,Structure Fire,111,111 - Building fire,0,1000,1000,30000,29000
3826,2013,Spring,2/13/2013,315 MEADOWOOD 1 City of Louisville KY 40214,Structure Fire,111,111 - Building fire,0,2000,2000,150000,148000
4004,2013,Spring,2/15/2013,937 W EVELYN 0 City of Louisville KY 40215,Structure Fire,111,111 - Building fire,10000,20000,30000,70000,40000
4069,2013,Spring,2/16/2013,2103 W OAK n'a City of Louisville KY 40210,Structure Fire,111,111 - Building fire,5000,20000,25000,100000,75000
4221,2013,Spring,2/18/2013,E KENTUCKY City of Louisville KY 40203,Vehicle Fire,131,131 - Passenger vehicle fire,0,2500,2500,3500,1000
4246,2013,Spring,2/18/2013,3713 CENTER n/a City of Louisville KY 40215,Structure Fire,111,111 - Building fire,500,2000,2500,14000,11500
4324,2013,Spring,2/19/2013,2731 BROWNSBORO na City of Louisville KY 40206,Vehicle Fire,131,131 - Passenger vehicle fire,0,3500,3500,3500,0
4343,2013,Spring,2/20/2013,380 I 64 West n/a City of Louisville KY 40202,Vehicle Fire,131,131 - Passenger vehicle fire,0,1400,1400,1400,0
4436,2013,Spring,2/21/2013,2016 DUNCAN N/A City of Louisville KY 40203,Structure Fire,111,111 - Building fire,0,2000,2000,28040,26040
4481,2013,Spring,2/21/2013,635 S 40TH n/a City of Louisville KY 40211,Structure Fire,111,111 - Building fire,1000,10000,11000,65000,54000
4529,2013,Spring,2/22/2013,6307 SOUTHSIDE na City of Louisville KY 40214,Structure Fire,111,111 - Building fire,600,0,600,0,-600
4540,2013,Spring,2/22/2013,I 65 North NA City of Audubon Park KY 40213,Vehicle Fire,131,131 - Passenger vehicle fire,200,2500,2700,2500,-200
4669,2013,Spring,2/24/2013,S 38TH City of Louisville KY 40211,Vehicle Fire,131,131 - Passenger vehicle fire,0,3500,3500,3500,0
4681,2013,Spring,2/24/2013,3411 W MAIN na City of Louisville KY 40212,Vehicle Fire,131,131 - Passenger vehicle fire,0,3500,3500,3500,0
4737,2013,Spring,2/24/2013,4330 SANITA n/a City of Audubon Park KY 40213,Vehicle Fire,132,132 - Road freight or transport vehicle fire,500,100000,100500,100000,-500
4816,2013,Spring,2/25/2013,219 S 25TH n/a City of Louisville KY 40212,Structure Fire,111,111 - Building fire,0,7000,7000,7000,0
4836,2013,Spring,2/26/2013,3005 RIVER na City of Beechwood Village KY 40207,Structure Fire,111,111 - Building fire,500,500,1000,1000000,999000
4913,2013,Spring,2/27/2013,814 S 37TH na City of Louisville KY 40211,Structure Fire,111,111 - Building fire,500,2500,3000,2500,-500
4948,2013,Spring,2/27/2013,3241 HERMAN n/a City of Louisville KY 40212,Structure Fire,111,111 - Building fire,1000,0,1000,50000,49000
5036,2013,Spring,3/1/2013,4141 W BROADWAY 1 City of Louisville KY 40211,Structure Fire,111,111 - Building fire,2500,20000,22500,84510,62010
5054,2013,Spring,3/1/2013,DUTCHMANS City of Kingsley KY 40205,Vehicle Fire,131,131 - Passenger vehicle fire,0,1400,1400,1400,0
5080,2013,Spring,3/1/2013,3829 SOUTHERN na City of Louisville KY 40214,Vehicle Fire,131,131 - Passenger vehicle fire,0,5825,5825,5825,0
5094,2013,Spring,3/1/2013,4020 GARLAND na City of Louisville KY 40211,Vehicle Fire,131,131 - Passenger vehicle fire,0,150,150,2500,2350
5119,2013,Spring,3/2/2013,3901 TAYLORSVILLE n/a City of Cambridge KY 40220,Outside Fire,162,162 - Outside equipment fire,1000,0,1000,0,-1000
5216,2013,Spring,3/3/2013,1221 CYPRESS N/A City of Louisville KY 40211,Structure Fire,111,111 - Building fire,5000,20760,25760,20760,-5000
5231,2013,Spring,3/3/2013,1468 S 9TH N/A City of Louisville KY 40208,Vehicle Fire,131,131 - Passenger vehicle fire,0,1000,1000,1000,0
5216,2013,Spring,3/3/2013,1217 CYPRESS N/A City of Louisville KY 40211,Structure Fire,111,111 - Building fire,5000,10000,15000,38200,23200
5479,2013,Spring,3/6/2013,2107 GOLDSMITH Legend #7 City of Louisville KY 40218,Structure Fire,111,111 - Building fire,50,0,50,300000,299950
5528,2013,Spring,3/7/2013,745 S 37TH na City of Louisville KY 40211,Structure Fire,111,111 - Building fire,3000,10000,13000,38000,25000
5541,2013,Spring,3/7/2013,2509 GRIFFITHS N/A City of Louisville KY 40212,Structure Fire,113,"113 - Cooking fire, confined to container",100,0,100,NULL,NULL
5528,2013,Spring,3/7/2013,743 S 37TH na City of Louisville KY 40211,Structure Fire,111,111 - Building fire,0,1000,1000,35000,34000
5613,2013,Spring,3/8/2013,466 S 11TH na City of Louisville KY 40203,Vehicle Fire,131,131 - Passenger vehicle fire,0,1500,1500,1500,0
5645,2013,Spring,3/8/2013,2226 LIVERPOOL N/A City of Louisville KY 40218,Structure Fire,111,111 - Building fire,0,500,500,761800,761300
5758,2013,Spring,3/9/2013,1705 COWLING N/A City of Kingsley KY 40205,Structure Fire,111,111 - Building fire,15000,140000,155000,277000,122000
5758,2013,Spring,3/9/2013,1707 COWLING N/A City of Kingsley KY 40205,Structure Fire,111,111 - Building fire,0,2500,2500,176000,173500
5782,2013,Spring,3/10/2013,1954 ROANOKE N/A City of Kingsley KY 40205,Vehicle Fire,131,131 - Passenger vehicle fire,0,4000,4000,4000,0
5792,2013,Spring,3/10/2013,634 E LIBERTY n/a City of Louisville KY 40202,Vehicle Fire,131,131 - Passenger vehicle fire,0,2000,2000,8000,6000
5842,2013,Spring,3/10/2013,4013 W MARKET n/a City of Louisville KY 40212,Structure Fire,111,111 - Building fire,500,0,500,0,-500
5849,2013,Spring,3/10/2013,MANSLICK City of Louisville KY 40214,Vehicle Fire,131,131 - Passenger vehicle fire,0,2000,2000,2000,0
5924,2013,Spring,3/11/2013,3907 W MARKET n/a City of Louisville KY 40212,Structure Fire,111,111 - Building fire,5000,65000,70000,65000,-5000
5926,2013,Spring,3/11/2013,2524 S 4TH n/a City of Louisville KY 40208,Structure Fire,111,111 - Building fire,2000,5000,7000,48000,41000
6148,2013,Spring,3/14/2013,2015 S FIRST STREET n/a City of Louisville KY 40208,Structure Fire,111,111 - Building fire,0,2000,2000,8000,6000
6151,2013,Spring,3/14/2013,1427 S 28TH n/a City of Louisville KY 40211,Structure Fire,111,111 - Building fire,250,5000,5250,5000,-250
6175,2013,Spring,3/14/2013,1818 PORTLAND None City of Louisville KY 40203,Vehicle Fire,131,131 - Passenger vehicle fire,0,1000,1000,5000,4000
6229,2013,Spring,3/15/2013,906 ROADWAY 0 City of Louisville KY 40208,Structure Fire,118,"118 - Trash or rubbish fire, contained",0,50,50,34500,34450
6353,2013,Spring,3/16/2013,616 EMILY N/A City of Louisville KY 40206,Structure Fire,112,112 - Fires in structure other than in a building,200,500,700,65000,64300
6490,2013,Spring,3/18/2013,3725 GREENWICH na City of Louisville KY 40218,Structure Fire,111,111 - Building fire,75000,75000,150000,150000,0
6490,2013,Spring,3/18/2013,3725 GREENWICH na City of Louisville KY 40218,Structure Fire,111,111 - Building fire,0,2000,2000,20000,18000
6511,2013,Spring,3/18/2013,2131 W BROADWAY N/A City of Louisville KY 40211,Outside Fire,154,154 - Dumpster or other outside trash receptacle fire,0,100,100,500,400
6668,2013,Spring,3/20/2013,5414 NEW CUT n/a City of Louisville KY 40214,Vehicle Fire,131,131 - Passenger vehicle fire,0,3000,3000,14000,11000
6875,2013,Spring,3/22/2013,1528 W OAK na City of Louisville KY 40210,Structure Fire,111,111 - Building fire,0,20000,20000,20000,0
6946,2013,Spring,3/23/2013,639 GHEENS n/a City of Louisville KY 40214,Vehicle Fire,131,131 - Passenger vehicle fire,0,1500,1500,2500,1000
6961,2013,Spring,3/24/2013,3828 W MUHAMMAD ALI n/a City of Louisville KY 40212,Structure Fire,111,111 - Building fire,0,10000,10000,50000,40000
7019,2013,Spring,3/24/2013,723 DENMARK n/a City of Louisville KY 40215,Structure Fire,111,111 - Building fire,1000,5000,6000,15000,9000
7086,2013,Spring,3/25/2013,3422 RIVER PARK n/a City of Louisville KY 40211,Structure Fire,111,111 - Building fire,600,1000,1600,28000,26400
7087,2013,Spring,3/25/2013,2357 PAYNE N/A City of Louisville KY 40206,Structure Fire,111,111 - Building fire,5000,1000,6000,25000,19000
7100,2013,Spring,3/25/2013,1201 EVERETT N/A City of Louisville KY 40204,Structure Fire,113,"113 - Cooking fire, confined to container",600,0,600,NULL,NULL
7146,2013,Spring,3/26/2013,304 CECIL N/A City of Louisville KY 40212,Structure Fire,111,111 - Building fire,100,100,200,62890,62690
7158,2013,Spring,3/26/2013,1306 LARCHMONT 0 City of Louisville KY 40215,Structure Fire,111,111 - Building fire,25000,50000,75000,60000,-15000
7177,2013,Spring,3/26/2013,1200 MAPLE N/A City of Louisville KY 40210,Structure Fire,111,111 - Building fire,10000,0,10000,800000,790000
7204,2013,Spring,3/26/2013,400BK MACLEAN n/a City of Louisville KY 40209,Vehicle Fire,132,132 - Road freight or transport vehicle fire,500,20000,20500,20000,-500
7234,2013,Spring,3/27/2013,700 W EVELYN n\a City of Louisville KY 40215,Vehicle Fire,131,131 - Passenger vehicle fire,0,500,500,1000,500
7312,2013,Spring,3/28/2013,385 I 64 West na City of Louisville KY 40202,Vehicle Fire,131,131 - Passenger vehicle fire,0,200,200,200,0
7340,2013,Spring,3/28/2013,2310 W JEFFERSON N/A City of Louisville KY 40212,Structure Fire,111,111 - Building fire,0,2000,2000,100000,98000
7470,2013,Spring,3/30/2013,SENECA VALLEY City of Kingsley KY 40205,Vehicle Fire,131,131 - Passenger vehicle fire,0,5000,5000,5000,0
7516,2013,Spring,3/30/2013,1811 CARL 1 City of Louisville KY 40215,Structure Fire,113,"113 - Cooking fire, confined to container",400,1,401,2000000,1999599
7675,2013,Spring,4/1/2013,113 N BIRCHWOOD n/a City of Louisville KY 40206,Structure Fire,111,111 - Building fire,10000,50000,60000,114230,54230
7608,2013,Spring,4/1/2013,741 IOWA N/A City of Louisville KY 40208,Vehicle Fire,131,131 - Passenger vehicle fire,100,5000,5100,5000,-100
7684,2013,Spring,4/2/2013,3316 NOE B6 City of Cambridge KY 40220,Structure Fire,111,111 - Building fire,0,250,250,236550,236300
7737,2013,Spring,4/2/2013,1330 LONGFIELD na City of Louisville KY 40215,Outside Fire,151,"151 - Outside rubbish, trash or waste fire",0,300,300,1000,700
7759,2013,Spring,4/2/2013,1919 W MARKET n/a City of Louisville KY 40203,Structure Fire,111,111 - Building fire,1000,5000,6000,5000,-1000
7767,2013,Spring,4/3/2013,105 FOREST 2A City of Louisville KY 40206,Structure Fire,118,"118 - Trash or rubbish fire, contained",500,0,500,215000,214500
7790,2013,Spring,4/3/2013,1920 ROWAN N/A City of Louisville KY 40203,Structure Fire,111,111 - Building fire,0,10000,10000,80000,70000
7820,2013,Spring,4/3/2013,123 N 42ND n/a City of Louisville KY 40212,Structure Fire,111,111 - Building fire,400,100,500,35000,34500
7853,2013,Spring,4/4/2013,4329 HAZELWOOD 8B-10 City of Louisville KY 40215,Structure Fire,111,111 - Building fire,1000,1000,2000,80000,78000
7977,2013,Spring,4/5/2013,509 BRENTWOOD N\A City of Louisville KY 40215,Structure Fire,111,111 - Building fire,0,2000,2000,60000,58000
7990,2013,Spring,4/5/2013,22 NICHOLS n/a City of Louisville KY 40215,Structure Fire,111,111 - Building fire,1,4500,4501,61110,56609
7997,2013,Spring,4/5/2013,540 S 24TH 1 City of Louisville KY 40211,Structure Fire,113,"113 - Cooking fire, confined to container",100,1000,1100,30470,29370
8064,2013,Spring,4/6/2013,236 W MUHAMMAD ALI N/A City of Louisville KY 40202,Vehicle Fire,131,131 - Passenger vehicle fire,0,1000,1000,5000,4000
8085,2013,Spring,4/6/2013,306 W AMHERST Attic Area City of Louisville KY 40214,Structure Fire,111,111 - Building fire,85000,70000,155000,700000,545000
8092,2013,Spring,4/6/2013,3024 W KENTUCKY n/a City of Louisville KY 40211,Structure Fire,111,111 - Building fire,0,1000,1000,1500,500
8195,2013,Spring,4/7/2013,4116 GREENWOOD N/A City of Louisville KY 40211,Structure Fire,111,111 - Building fire,0,100,100,75000,74900
8241,2013,Spring,4/8/2013,1225 W BURNETT NA City of Louisville KY 40210,Structure Fire,111,111 - Building fire,2500,0,2500,0,-2500
8245,2013,Spring,4/8/2013,520 N 17TH n/a City of Louisville KY 40203,Structure Fire,111,111 - Building fire,1000,5000,6000,33880,27880
8323,2013,Spring,4/9/2013,1205 LONGFIELD N/A City of Louisville KY 40215,Outside Fire,161,161 - Outside storage fire,500,500,1000,5000,4000
8333,2013,Spring,4/9/2013,1501 BELLAMY Clubhouse City of Louisville KY 40208,Outside Fire,151,"151 - Outside rubbish, trash or waste fire",100,0,100,0,-100
8369,2013,Spring,4/9/2013,S 15TH City of Louisville KY 40203,Vehicle Fire,131,131 - Passenger vehicle fire,500,4000,4500,8700,4200
8394,2013,Spring,4/9/2013,S 6TH City of Louisville KY 40203,Vehicle Fire,131,131 - Passenger vehicle fire,0,1500,1500,5000,3500
8437,2013,Spring,4/10/2013,4315 BANK 0 City of Louisville KY 40212,Vehicle Fire,131,131 - Passenger vehicle fire,0,11500,11500,11500,0
8516,2013,Spring,4/10/2013,104 IROQUOIS GARDENS 104 City of Louisville KY 40214,Structure Fire,113,"113 - Cooking fire, confined to container",0,200,200,300000,299800
8526,2013,Spring,4/10/2013,1100 E ST CATHERINE N/A City of Louisville KY 40204,Structure Fire,111,111 - Building fire,0,1500,1500,100000,98500
8543,2013,Spring,4/11/2013,704 W WHITNEY 0 City of Louisville KY 40215,Vehicle Fire,131,131 - Passenger vehicle fire,0,25000,25000,25000,0
8580,2013,Spring,4/11/2013,3003 PENWAY N/A City of Louisville KY 40210,Structure Fire,113,"113 - Cooking fire, confined to container",500,0,500,60000,59500
8782,2013,Spring,4/13/2013,1353 SALE 0 City of Louisville KY 40215,Outside Fire,150,"150 - Outside rubbish fire, other",0,200,200,5000,4800
8789,2013,Spring,4/13/2013,3506 TAYLOR N/A City of Louisville KY 40215,Outside Fire,151,"151 - Outside rubbish, trash or waste fire",0,100,100,500,400
8807,2013,Spring,4/14/2013,S 38TH City of Louisville KY 40211,Vehicle Fire,131,131 - Passenger vehicle fire,0,13521,13521,13521,0
8817,2013,Spring,4/14/2013,123 W MAIN N/A City of Louisville KY 40202,Structure Fire,111,111 - Building fire,100,0,100,3200000,3199900
9095,2013,Spring,4/17/2013,304 CECIL n/a City of Louisville KY 40212,Structure Fire,111,111 - Building fire,500,10000,10500,60000,49500
9236,2013,Spring,4/18/2013,4504 VIRGINIA n/a City of Louisville KY 40211,Structure Fire,111,111 - Building fire,5000,15000,20000,35000,15000
9236,2013,Spring,4/18/2013,4504 VIRGINIA n/a City of Louisville KY 40211,Structure Fire,111,111 - Building fire,500,2000,2500,45000,42500
9372,2013,Spring,4/19/2013,1333 THORNBERRY N/A City of Louisville KY 40215,Structure Fire,111,111 - Building fire,5000,20000,25000,110000,85000
9398,2013,Spring,4/20/2013,1460 S 7TH NA City of Louisville KY 40208,Structure Fire,111,111 - Building fire,10000,15000,25000,65000,40000
9452,2013,Spring,4/20/2013,1148 DIXIE N/A City of Louisville KY 40210,Structure Fire,111,111 - Building fire,10000,8500,18500,17010,-1490
9604,2013,Spring,4/22/2013,1013 TREVILIAN n/a City of Audubon Park KY 40213,Structure Fire,111,111 - Building fire,0,500,500,2000,1500
9619,2013,Spring,4/22/2013,4020 SOUTHERN N/A City of Louisville KY 40214,Structure Fire,111,111 - Building fire,500,1000,1500,1500,0
9679,2013,Spring,4/23/2013,1100BLK S 32ND na City of Louisville KY 40211,Outside Fire,151,"151 - Outside rubbish, trash or waste fire",0,300,300,300,0
9770,2013,Spring,4/24/2013,319 IDLEWYLDE 10 City of Louisville KY 40206,Structure Fire,111,111 - Building fire,500,15000,15500,444000,428500
9834,2013,Spring,4/24/2013,I 65 North n/a City of Audubon Park KY 40213,Vehicle Fire,131,131 - Passenger vehicle fire,200,4000,4200,4000,-200
9981,2013,Spring,4/26/2013,422 MARSHALL n/a City of Louisville KY 40214,Structure Fire,111,111 - Building fire,0,15000,15000,4018600,4003600
10065,2013,Spring,4/27/2013,110 S 39TH N/A City of Louisville KY 40212,Structure Fire,111,111 - Building fire,600,0,600,0,-600
10095,2013,Spring,4/27/2013,1546 LOUIS COLEMAN JR n/a City of Louisville KY 40211,Outside Fire,151,"151 - Outside rubbish, trash or waste fire",0,50,50,50,0
10196,2013,Spring,4/29/2013,1233 CYPRESS C City of Louisville KY 40211,Structure Fire,111,111 - Building fire,500,10000,10500,159600,149100
10311,2013,Spring,4/30/2013,412 WEST 38 City of Louisville KY 40203,Structure Fire,111,111 - Building fire,500,1000,1500,200000,198500
10365,2013,Summer,5/1/2013,W LIBERTY City of Louisville KY 40203,Structure Fire,111,111 - Building fire,100,1000,1100,200000,198900
10418,2013,Summer,5/1/2013,13301 I 65 North N/A City of Louisville KY 40217,Vehicle Fire,130,"130 - Mobile property (vehicle) fire, other",0,12000,12000,12000,0
10430,2013,Summer,5/1/2013,924 E LIBERTY 4 City of Louisville KY 40204,Structure Fire,113,"113 - Cooking fire, confined to container",300,0,300,300000,299700
10442,2013,Summer,5/1/2013,400 S 8TH 1702 City of Louisville KY 40203,Structure Fire,111,111 - Building fire,25,0,25,1000000,999975
10471,2013,Summer,5/2/2013,S 10TH City of Louisville KY 40203,Vehicle Fire,131,131 - Passenger vehicle fire,0,1000,1000,1500,500
10510,2013,Summer,5/2/2013,5109 NEW CUT na City of Louisville KY 40214,Structure Fire,111,111 - Building fire,1000,2000,3000,500000,497000
10549,2013,Summer,5/2/2013,S 4TH City of Louisville KY 40208,Vehicle Fire,131,131 - Passenger vehicle fire,0,4500,4500,4500,0
10586,2013,Summer,5/3/2013,W LIBERTY City of Louisville KY 40202,Vehicle Fire,131,131 - Passenger vehicle fire,0,5000,5000,10000,5000
10623,2013,Summer,5/3/2013,4615 TAYLOR n/a City of Louisville KY 40215,Structure Fire,111,111 - Building fire,4000,1000,5000,20000,15000
10673,2013,Summer,5/4/2013,3110 PRESTON n/a City of Audubon Park KY 40213,Structure Fire,111,111 - Building fire,1000,2500,3500,300000,296500
10708,2013,Summer,5/4/2013,1173 S 41ST na City of Louisville KY 40211,Structure Fire,111,111 - Building fire,5000,10000,15000,10000,-5000
10709,2013,Summer,5/4/2013,100 N 26TH 1 City of Louisville KY 40212,Structure Fire,118,"118 - Trash or rubbish fire, contained",0,100,100,100,0
10713,2013,Summer,5/4/2013,108 S 42ND na City of Louisville KY 40212,Vehicle Fire,131,131 - Passenger vehicle fire,0,500,500,2800,2300
10731,2013,Summer,5/4/2013,324 E MAIN N/A City of Louisville KY 40202,Outside Fire,151,"151 - Outside rubbish, trash or waste fire",0,100,100,750000,749900
10771,2013,Summer,5/5/2013,2809 S 4TH 1 City of Louisville KY 40208,Structure Fire,111,111 - Building fire,1000,0,1000,NULL,NULL
10838,2013,Summer,5/5/2013,519 W HILL n/a City of Louisville KY 40208,Structure Fire,111,111 - Building fire,2500,0,2500,0,-2500
10874,2013,Summer,5/6/2013,1440 I 264 West N/A City of Louisville KY 40218,Vehicle Fire,132,132 - Road freight or transport vehicle fire,1000,100000,101000,100000,-1000
11111,2013,Summer,5/8/2013,3736 WARREN n/a City of Louisville KY 40215,Structure Fire,111,111 - Building fire,10000,20000,30000,50000,20000
11232,2013,Summer,5/9/2013,534 WARNOCK N/A City of Louisville KY 40217,Structure Fire,112,112 - Fires in structure other than in a building,300,0,300,0,-300
11397,2013,Summer,5/11/2013,113 E KINGSTON 4 City of Louisville KY 40214,Structure Fire,113,"113 - Cooking fire, confined to container",200,0,200,NULL,NULL
11449,2013,Summer,5/12/2013,547 S SHELBY n/a City of Louisville KY 40202,Vehicle Fire,131,131 - Passenger vehicle fire,0,3500,3500,3500,0
11451,2013,Summer,5/12/2013,1501 STORY N/A City of Louisville KY 40206,Vehicle Fire,131,131 - Passenger vehicle fire,150,500,650,3000,2350
11504,2013,Summer,5/12/2013,2616 VALLETTA n/a City of Kingsley KY 40205,Structure Fire,111,111 - Building fire,4000,2000,6000,220000,214000
11507,2013,Summer,5/12/2013,1743 LINCOLN N/A City of Audubon Park KY 40213,Structure Fire,111,111 - Building fire,500,0,500,78500,78000
11520,2013,Summer,5/13/2013,2106 DUMESNIL na City of Louisville KY 40210,Structure Fire,111,111 - Building fire,5000,4000,9000,22980,13980
11520,2013,Summer,5/13/2013,2104 DUMESNIL na City of Louisville KY 40210,Structure Fire,111,111 - Building fire,0,1000,1000,22650,21650
11567,2013,Summer,5/13/2013,607 W ORMSBY n/a City of Louisville KY 40203,Vehicle Fire,131,131 - Passenger vehicle fire,0,1000,1000,3000,2000
11574,2013,Summer,5/13/2013,741 S 35TH na City of Louisville KY 40211,Vehicle Fire,131,131 - Passenger vehicle fire,0,600,600,2300,1700
11599,2013,Summer,5/14/2013,2520 W MUHAMMAD ALI na City of Louisville KY 40212,Vehicle Fire,131,131 - Passenger vehicle fire,0,2000,2000,2000,0
11651,2013,Summer,5/14/2013,536 BAXTER 1 City of Louisville KY 40204,Structure Fire,111,111 - Building fire,5000,7500,12500,160000,147500
11801,2013,Summer,5/16/2013,2348 CRITTENDEN N/A City of Louisville KY 40217,Structure Fire,111,111 - Building fire,0,5000,5000,125000,120000
11815,2013,Summer,5/16/2013,2513 ELLIOTT na City of Louisville KY 40211,Structure Fire,118,"118 - Trash or rubbish fire, contained",0,1000,1000,1000,0
12261,2013,Summer,5/20/2013,1022 CHEROKEE n/a City of Louisville KY 40204,Structure Fire,111,111 - Building fire,50000,100000,150000,600000,450000
12333,2013,Summer,5/21/2013,6 NORMANDIE n/a City of Kingsley KY 40205,Vehicle Fire,131,131 - Passenger vehicle fire,0,500,500,1000,500
12395,2013,Summer,5/22/2013,2316 DUNDEE n/a City of Kingsley KY 40205,Structure Fire,111,111 - Building fire,3500,3500,7000,200000,193000
12397,2013,Summer,5/22/2013,1223 S 4TH 21 City of Louisville KY 40203,Outside Fire,160,"160 - Special outside fire, other",300,0,300,0,-300
12433,2013,Summer,5/22/2013,3118 MAYWOOD n/a City of Cambridge KY 40220,Structure Fire,112,112 - Fires in structure other than in a building,100,0,100,15000,14900
12509,2013,Summer,5/23/2013,732 E MARKET N/A City of Louisville KY 40202,Outside Fire,154,154 - Dumpster or other outside trash receptacle fire,0,100,100,2500,2400
12573,2013,Summer,5/24/2013,1018 S 3RD 1B City of Louisville KY 40203,Structure Fire,111,111 - Building fire,100,400,500,197120,196620
12642,2013,Summer,5/24/2013,1346 HUNTOON n/a City of Louisville KY 40215,Vehicle Fire,131,131 - Passenger vehicle fire,0,3000,3000,3000,0
12671,2013,Summer,5/25/2013,S 12TH City of Louisville KY 40203,Vehicle Fire,131,131 - Passenger vehicle fire,0,1000,1000,5000,4000
12787,2013,Summer,5/26/2013,1240 I 264 West N/A City of Louisville KY 40209,Vehicle Fire,131,131 - Passenger vehicle fire,800,10000,10800,10000,-800
12801,2013,Summer,5/26/2013,3448 ALLISON N/A City of Cambridge KY 40220,Vehicle Fire,131,131 - Passenger vehicle fire,0,6500,6500,6500,0
12824,2013,Summer,5/27/2013,3726 WHEELER n/a City of Louisville KY 40215,Structure Fire,111,111 - Building fire,0,30000,30000,60000,30000
12843,2013,Summer,5/27/2013,2025 BROWNSBORO 402 City of Louisville KY 40206,Structure Fire,111,111 - Building fire,2000,2000,4000,300000,296000
12917,2013,Summer,5/28/2013,925 EUCLID n/a City of Louisville KY 40208,Vehicle Fire,131,131 - Passenger vehicle fire,200,9000,9200,9000,-200
12941,2013,Summer,5/28/2013,6408 SIX MILE 124 City of Louisville KY 40218,Structure Fire,113,"113 - Cooking fire, confined to container",200,800,1000,800,-200
12999,2013,Summer,5/28/2013,1000 I 264 East n/a City of Louisville KY 40214,Vehicle Fire,131,131 - Passenger vehicle fire,0,1000,1000,1000,0
13123,2013,Summer,5/30/2013,E WITHERSPOON City of Louisville KY 40202,Vehicle Fire,131,131 - Passenger vehicle fire,0,1000,1000,1000,0
13199,2013,Summer,5/31/2013,1437 MORTON 2 City of Louisville KY 40204,Structure Fire,111,111 - Building fire,10000,100000,110000,300000,190000
13200,2013,Summer,5/31/2013,N 22ND City of Louisville KY 40203,Vehicle Fire,130,"130 - Mobile property (vehicle) fire, other",0,2500,2500,2500,0
13205,2013,Summer,5/31/2013,1333 QUINCY N/A City of Louisville KY 40206,Structure Fire,111,111 - Building fire,500,0,500,60000,59500
13199,2013,Summer,5/31/2013,1435 MORTON 2 City of Louisville KY 40204,Structure Fire,111,111 - Building fire,0,2000,2000,300000,298000
13355,2013,Summer,6/1/2013,1810 COLUMBIA N/A City of Louisville KY 40203,Structure Fire,111,111 - Building fire,4000,8000,12000,30000,18000
13383,2013,Summer,6/2/2013,1719 BOLLING N/A City of Louisville KY 40210,Outside Fire,150,"150 - Outside rubbish fire, other",100,0,100,0,-100
13478,2013,Summer,6/2/2013,1542 SANDERS na City of Louisville KY 40216,Structure Fire,111,111 - Building fire,5000,25000,30000,25000,-5000
13500,2013,Summer,6/3/2013,1062 BARDSTOWN basement City of Louisville KY 40204,Structure Fire,111,111 - Building fire,500,100,600,250000,249400
13553,2013,Summer,6/3/2013,3305 INDIAN CREEK 1 City of Louisville KY 40218,Structure Fire,111,111 - Building fire,0,3500,3500,3500,0
13621,2013,Summer,6/4/2013,3228 RIVER PARK na City of Louisville KY 40211,Vehicle Fire,131,131 - Passenger vehicle fire,0,1500,1500,3000,1500
13831,2013,Summer,6/7/2013,672 S 26TH N/A City of Louisville KY 40211,Structure Fire,118,"118 - Trash or rubbish fire, contained",0,1000,1000,13000,12000
13875,2013,Summer,6/7/2013,401 KENILWORTH 10 City of Louisville KY 40206,Structure Fire,111,111 - Building fire,1000,1000,2000,300000,298000
13886,2013,Summer,6/7/2013,TAYLOR City of Louisville KY 40215,Vehicle Fire,131,131 - Passenger vehicle fire,0,2500,2500,2500,0
13916,2013,Summer,6/7/2013,POPLAR LEVEL City of Audubon Park KY 40213,Vehicle Fire,131,131 - Passenger vehicle fire,0,7500,7500,7500,0
13937,2013,Summer,6/8/2013,1719 W OAK N/A City of Louisville KY 40210,Structure Fire,113,"113 - Cooking fire, confined to container",1000,0,1000,0,-1000
13938,2013,Summer,6/8/2013,2238 VILLAGE N/A City of Kingsley KY 40205,Outside Fire,150,"150 - Outside rubbish fire, other",50,0,50,0,-50
14035,2013,Summer,6/9/2013,423 SHELBY n/a City of Louisville KY 40203,Vehicle Fire,131,131 - Passenger vehicle fire,0,4000,4000,4000,0
14287,2013,Summer,6/12/2013,416 S 26TH N/A City of Louisville KY 40212,Vehicle Fire,131,131 - Passenger vehicle fire,200,2000,2200,10000,7800
14472,2013,Summer,6/13/2013,201 YORK 210 City of Louisville KY 40203,Structure Fire,111,111 - Building fire,1000,5000,6000,2000000,1994000
14460,2013,Summer,6/13/2013,1722 HALE N/A City of Louisville KY 40210,Structure Fire,111,111 - Building fire,0,200,200,1000,800
14590,2013,Summer,6/15/2013,2021 LYTLE n/a City of Louisville KY 40203,Structure Fire,111,111 - Building fire,0,5000,5000,60000,55000
14596,2013,Summer,6/15/2013,N 24TH City of Louisville KY 40212,Vehicle Fire,131,131 - Passenger vehicle fire,0,6500,6500,6500,0
14625,2013,Summer,6/15/2013,2023 LYTLE N/A City of Louisville KY 40203,Structure Fire,111,111 - Building fire,0,4100,4100,4100,0
14708,2013,Summer,6/16/2013,915 E MUHAMMAD ALI 1 City of Louisville KY 40204,Structure Fire,111,111 - Building fire,500,3000,3500,43610,40110
14712,2013,Summer,6/16/2013,810 W WHITNEY n/a City of Louisville KY 40215,Structure Fire,111,111 - Building fire,4000,15000,19000,55000,36000
14758,2013,Summer,6/16/2013,403 CORNELL n/a City of Beechwood Village KY 40207,Structure Fire,111,111 - Building fire,25,0,25,10000,9975
14799,2013,Summer,6/17/2013,781 I 64 West n/a City of Louisville KY 40206,Vehicle Fire,131,131 - Passenger vehicle fire,250,2000,2250,2000,-250
14958,2013,Summer,6/18/2013,3100 POPLAR LEVEL n/a City of Audubon Park KY 40213,Vehicle Fire,131,131 - Passenger vehicle fire,0,2000,2000,2000,0
15120,2013,Summer,6/20/2013,3445 LARKWOOD na City of Louisville KY 40212,Structure Fire,111,111 - Building fire,0,7500,7500,40000,32500
15203,2013,Summer,6/21/2013,211 N 17TH N/A City of Louisville KY 40203,Structure Fire,111,111 - Building fire,0,23790,23790,23790,0
15203,2013,Summer,6/21/2013,215 N 17TH N/A City of Louisville KY 40203,Structure Fire,111,111 - Building fire,0,19730,19730,19730,0
15415,2013,Summer,6/23/2013,1500BLK BERNHEIM N/A City of Louisville KY 40210,Outside Fire,162,162 - Outside equipment fire,1000,0,1000,0,-1000
15528,2013,Summer,6/24/2013,NEW CUT City of Louisville KY 40214,Vehicle Fire,131,131 - Passenger vehicle fire,200,5000,5200,8000,2800
15595,2013,Summer,6/25/2013,1100B E MAIN N/A City of Louisville KY 40206,Vehicle Fire,132,132 - Road freight or transport vehicle fire,0,10000,10000,50000,40000
15614,2013,Summer,6/25/2013,1000 I 264 East n/a City of Louisville KY 40214,Vehicle Fire,131,131 - Passenger vehicle fire,0,2000,2000,2000,0
15623,2013,Summer,6/25/2013,S 22ND City of Louisville KY 40212,Vehicle Fire,130,"130 - Mobile property (vehicle) fire, other",0,100,100,100,0
15836,2013,Summer,6/27/2013,2251 HIKES N/A City of Louisville KY 40218,Vehicle Fire,131,131 - Passenger vehicle fire,0,3000,3000,3000,0
15857,2013,Summer,6/27/2013,1947 FRANKFORT N/A City of Louisville KY 40206,Vehicle Fire,131,131 - Passenger vehicle fire,0,2500,2500,3500,1000
15904,2013,Summer,6/28/2013,114 W ST CATHERINE 3 City of Louisville KY 40203,Structure Fire,111,111 - Building fire,1500,500,2000,300000,298000
15935,2013,Summer,6/28/2013,3816 WEWOKA na City of Louisville KY 40212,Structure Fire,111,111 - Building fire,120000,16000,136000,16000,-120000
15935,2013,Summer,6/28/2013,3816 WEWOKA na City of Louisville KY 40212,Structure Fire,111,111 - Building fire,0,5000,5000,5000,0
15935,2013,Summer,6/28/2013,3814 WEWOKA na City of Louisville KY 40212,Structure Fire,111,111 - Building fire,0,2000,2000,65000,63000
15935,2013,Summer,6/28/2013,3814 WEWOKA na City of Louisville KY 40212,Structure Fire,111,111 - Building fire,0,1000,1000,10000,9000
16003,2013,Summer,6/29/2013,1918 MELLWOOD N/A City of Louisville KY 40206,Vehicle Fire,131,131 - Passenger vehicle fire,1000,20000,21000,20000,-1000
16090,2013,Summer,6/30/2013,114 S 33RD 0 City of Louisville KY 40212,Structure Fire,111,111 - Building fire,10000,20000,30000,85000,55000
16109,2013,Summer,6/30/2013,3013 MID DALE N/A City of Cambridge KY 40220,Vehicle Fire,131,131 - Passenger vehicle fire,3000,2000,5000,2000,-3000
16112,2013,Summer,6/30/2013,3714 NOBLITT 2 City of Louisville KY 40218,Structure Fire,111,111 - Building fire,200,5000,5200,160000,154800
16189,2013,Summer,7/1/2013,3026 VIRGINIA n/a City of Louisville KY 40211,Structure Fire,111,111 - Building fire,100,500,600,120000,119400
16202,2013,Summer,7/1/2013,W GAULBERT City of Louisville KY 40208,Vehicle Fire,131,131 - Passenger vehicle fire,0,1000,1000,2300,1300
16387,2013,Summer,7/3/2013,S 7TH City of Louisville KY 40203,Vehicle Fire,131,131 - Passenger vehicle fire,0,2000,2000,3000,1000
16465,2013,Summer,7/4/2013,3105 SUDBURY N/A City of Cambridge KY 40220,Structure Fire,111,111 - Building fire,3000,2000,5000,130000,125000
16561,2013,Summer,7/5/2013,1000 I 264 East na City of Louisville KY 40214,Vehicle Fire,131,131 - Passenger vehicle fire,0,500,500,2000,1500
16591,2013,Summer,7/5/2013,736 BURTON n/a City of Louisville KY 40208,Structure Fire,112,112 - Fires in structure other than in a building,0,2000,2000,45000,43000
16591,2013,Summer,7/5/2013,736 BURTON n/a City of Louisville KY 40208,Structure Fire,112,112 - Fires in structure other than in a building,5000,15000,20000,40000,20000
16619,2013,Summer,7/5/2013,128 E SOUTHLAND 2 City of Louisville KY 40214,Structure Fire,111,111 - Building fire,1000,5000,6000,90000,84000
16693,2013,Summer,7/6/2013,1924 CEDAR N/A City of Louisville KY 40203,Structure Fire,111,111 - Building fire,20000,50000,70000,50000,-20000
16719,2013,Summer,7/6/2013,1817 BOLLING na City of Louisville KY 40210,Vehicle Fire,131,131 - Passenger vehicle fire,0,2000,2000,4000,2000
16800,2013,Summer,7/7/2013,3104 PORTLAND n/a City of Louisville KY 40212,FALSE,151,"151 - Outside rubbish, trash or waste fire",500,0,500,NULL,NULL
16804,2013,Summer,7/7/2013,2323 W OAK N/A City of Louisville KY 40210,Structure Fire,111,111 - Building fire,2000,5000,7000,24630,17630
16805,2013,Summer,7/7/2013,3306 GREENWOOD N/A City of Louisville KY 40211,Structure Fire,116,"116 - Fuel burner/boiler malfunction, fire confined",0,500,500,50000,49500
16921,2013,Summer,7/9/2013,1591 SADIE N/A City of Louisville KY 40216,Structure Fire,118,"118 - Trash or rubbish fire, contained",0,300,300,165000,164700
17092,2013,Summer,7/10/2013,S 12TH City of Louisville KY 40210,Vehicle Fire,131,131 - Passenger vehicle fire,0,2000,2000,2000,0
17167,2013,Summer,7/10/2013,703 S 41ST 3 City of Louisville KY 40211,Structure Fire,111,111 - Building fire,3000,18000,21000,212750,191750
17306,2013,Summer,7/12/2013,1 AUDUBON PLAZA MRI City of Louisville KY 40217,Structure Fire,111,111 - Building fire,600,0,600,10000000,9999400
17369,2013,Summer,7/13/2013,2738 BANK n/a City of Louisville KY 40212,Structure Fire,111,111 - Building fire,0,30000,30000,35100,5100
17369,2013,Summer,7/13/2013,2734 BANK n/a City of Louisville KY 40212,Structure Fire,111,111 - Building fire,0,1500,1500,40000,38500
17412,2013,Summer,7/13/2013,2014 PORTLAND 2 City of Louisville KY 40203,Structure Fire,111,111 - Building fire,0,3000,3000,70000,67000
17455,2013,Summer,7/14/2013,1181 E BROADWAY n/a City of Louisville KY 40204,Vehicle Fire,131,131 - Passenger vehicle fire,200,2000,2200,2000,-200
17455,2013,Summer,7/14/2013,1181 E broadway n/a City of Louisville KY 40203,Vehicle Fire,131,131 - Passenger vehicle fire,0,4000,4000,9000,5000
17490,2013,Summer,7/14/2013,188 VERNON N/A City of Louisville KY 40206,Structure Fire,111,111 - Building fire,0,1000,1000,325790,324790
17542,2013,Summer,7/15/2013,833 LOUIS COLEMAN JR n/a City of Louisville KY 40211,Vehicle Fire,131,131 - Passenger vehicle fire,0,600,600,600,0
17581,2013,Summer,7/15/2013,3540 GARLAND na City of Louisville KY 40211,Structure Fire,111,111 - Building fire,500,12000,12500,12000,-500
17598,2013,Summer,7/15/2013,CHESTER City of Louisville KY 40204,Outside Fire,154,154 - Dumpster or other outside trash receptacle fire,0,200,200,500,300
17653,2013,Summer,7/15/2013,3401 TAYLOR N/A City of Louisville KY 40215,Structure Fire,111,111 - Building fire,1000,10000,11000,15000,4000
17772,2013,Summer,7/17/2013,S 13TH City of Louisville KY 40203,Outside Fire,151,"151 - Outside rubbish, trash or waste fire",0,2000,2000,2000,0
17857,2013,Summer,7/17/2013,3623 W BROADWAY 1 City of Louisville KY 40211,Structure Fire,113,"113 - Cooking fire, confined to container",500,500,1000,50000,49000
17883,2013,Summer,7/18/2013,508 LONGFIELD n/a City of Louisville KY 40214,Structure Fire,111,111 - Building fire,5000,2000,7000,2000,-5000
17968,2013,Summer,7/18/2013,3724 RIVER PARK n/a City of Louisville KY 40211,Outside Fire,162,162 - Outside equipment fire,0,100,100,100,0
18167,2013,Summer,7/20/2013,2403 BURWELL N/A City of Louisville KY 40210,Vehicle Fire,131,131 - Passenger vehicle fire,0,500,500,9000,8500
18173,2013,Summer,7/21/2013,635 CECIL N/A City of Louisville KY 40211,Outside Fire,151,"151 - Outside rubbish, trash or waste fire",3000,2000,5000,2000,-3000
18270,2013,Summer,7/21/2013,1244 S 4TH 417 City of Louisville KY 40203,Structure Fire,111,111 - Building fire,0,500,500,5000,4500
18348,2013,Summer,7/22/2013,UTAH City of Louisville KY 40215,Vehicle Fire,131,131 - Passenger vehicle fire,0,500,500,500,0
18351,2013,Summer,7/22/2013,1501 ARCADE 0 City of Louisville KY 40215,Vehicle Fire,131,131 - Passenger vehicle fire,0,500,500,500,0
18376,2013,Summer,7/23/2013,1310 HOWARD NA City of Audubon Park KY 40213,Structure Fire,111,111 - Building fire,1500,10000,11500,70000,58500
18485,2013,Summer,7/24/2013,2309 W LEE N/A City of Louisville KY 40210,Vehicle Fire,131,131 - Passenger vehicle fire,0,1000,1000,2500,1500
18485,2013,Summer,7/24/2013,2309 W LEE N/A City of Louisville KY 40210,Vehicle Fire,131,131 - Passenger vehicle fire,200,2975,3175,2975,-200
18497,2013,Summer,7/24/2013,426 DOWNES n/a City of Louisville KY 40214,Outside Fire,162,162 - Outside equipment fire,1500,3000,4500,3000,-1500
18596,2013,Summer,7/25/2013,2822 S 3RD 2 City of Louisville KY 40208,Structure Fire,111,111 - Building fire,800,1200,2000,72000,70000
18615,2013,Summer,7/25/2013,2644 CLEVELAND 44 City of Louisville KY 40206,Structure Fire,111,111 - Building fire,2200,6000,8200,1600000,1591800
18646,2013,Summer,7/25/2013,2406 ST XAVIER n/a City of Louisville KY 40212,Structure Fire,111,111 - Building fire,10000,40000,50000,60000,10000
18648,2013,Summer,7/25/2013,2234 DATE N/A City of Louisville KY 40210,Structure Fire,111,111 - Building fire,1000,45000,46000,70000,24000
18648,2013,Summer,7/25/2013,2236 DATE N/A City of Louisville KY 40210,Structure Fire,111,111 - Building fire,0,2000,2000,29000,27000
18648,2013,Summer,7/25/2013,2232 DATE N/A City of Louisville KY 40210,Structure Fire,111,111 - Building fire,0,4000,4000,43000,39000
18768,2013,Summer,7/27/2013,726 LOUIS COLEMAN JR N/A City of Louisville KY 40211,Vehicle Fire,131,131 - Passenger vehicle fire,300,2500,2800,2500,-300
18786,2013,Summer,7/27/2013,1124 FRANELM n/a City of Louisville KY 40214,Structure Fire,113,"113 - Cooking fire, confined to container",50,0,50,0,-50
18806,2013,Summer,7/27/2013,E WELLINGTON City of Louisville KY 40209,Structure Fire,112,112 - Fires in structure other than in a building,500,2000,2500,77000,74500
18807,2013,Summer,7/27/2013,3640 MANSLICK 18 City of Louisville KY 40215,Structure Fire,111,111 - Building fire,600,200,800,150000,149200
18847,2013,Summer,7/28/2013,S 41ST City of Louisville KY 40211,Vehicle Fire,131,131 - Passenger vehicle fire,0,4000,4000,4000,0
18873,2013,Summer,7/28/2013,822 W WHITNEY N/A City of Louisville KY 40215,Structure Fire,111,111 - Building fire,4750,9500,14250,19000,4750
18875,2013,Summer,7/28/2013,537 BEECHER N/A City of Louisville KY 40215,Structure Fire,111,111 - Building fire,0,2000,2000,50000,48000
18883,2013,Summer,7/28/2013,208 BONTRESSA N/A City of Louisville KY 40206,Structure Fire,111,111 - Building fire,0,200,200,15000,14800
18904,2013,Summer,7/28/2013,3622 GARLAND n/a City of Louisville KY 40211,Outside Fire,160,"160 - Special outside fire, other",0,200,200,1500,1300
18929,2013,Summer,7/29/2013,LOUIS COLEMAN JR City of Louisville KY 40211,Vehicle Fire,131,131 - Passenger vehicle fire,0,2000,2000,2000,0
19007,2013,Summer,7/29/2013,2030 BONNYCASTLE n/a City of Kingsley KY 40205,Vehicle Fire,131,131 - Passenger vehicle fire,0,3000,3000,3000,0
19008,2013,Summer,7/29/2013,1156 S 26TH na City of Louisville KY 40210,Structure Fire,118,"118 - Trash or rubbish fire, contained",0,100,100,14840,14740
19016,2013,Summer,7/29/2013,2411 PORTLAND 0 City of Louisville KY 40212,Vehicle Fire,131,131 - Passenger vehicle fire,0,500,500,1000,500
19070,2013,Summer,7/30/2013,3910 S 2ND N/A City of Louisville KY 40214,Structure Fire,113,"113 - Cooking fire, confined to container",500,0,500,NULL,NULL
19197,2013,Autumn,8/1/2013,3118 RADIANCE N/A City of Cambridge KY 40220,Vehicle Fire,131,131 - Passenger vehicle fire,1000,2000,3000,2250,-750
19206,2013,Autumn,8/1/2013,2501 RIVERMONT B7 City of Louisville KY 40206,Structure Fire,111,111 - Building fire,600,500,1100,750000,748900
19369,2013,Autumn,8/2/2013,2213 PATTERSON n/a City of Louisville KY 40204,Structure Fire,111,111 - Building fire,2000,7500,9500,250000,240500
19422,2013,Autumn,8/3/2013,1039 DR W J HODGE 2 City of Louisville KY 40210,Structure Fire,113,"113 - Cooking fire, confined to container",500,500,1000,25000,24000
19452,2013,Autumn,8/3/2013,1016 WINKLER n/a City of Louisville KY 40208,Structure Fire,111,111 - Building fire,0,1000,1000,40700,39700
19538,2013,Autumn,8/4/2013,4206 WINNROSE na City of Louisville KY 40211,Structure Fire,111,111 - Building fire,0,2000,2000,50000,48000
19540,2013,Autumn,8/4/2013,328 S 39TH n/a City of Louisville KY 40212,Structure Fire,111,111 - Building fire,0,2000,2000,43960,41960
19584,2013,Autumn,8/5/2013,2427 CEDAR na City of Louisville KY 40212,Vehicle Fire,131,131 - Passenger vehicle fire,0,2500,2500,2500,0
19619,2013,Autumn,8/5/2013,BAXTER City of Louisville KY 40204,Vehicle Fire,131,131 - Passenger vehicle fire,4000,0,4000,0,-4000
19625,2013,Autumn,8/5/2013,1329 S 26TH n/a City of Louisville KY 40210,Structure Fire,111,111 - Building fire,0,500,500,30000,29500
19628,2013,Autumn,8/5/2013,2420 FRANKFORT N/A City of Louisville KY 40206,Vehicle Fire,131,131 - Passenger vehicle fire,0,2000,2000,2500,500
19584,2013,Autumn,8/5/2013,2427 CEDAR na City of Louisville KY 40212,Structure Fire,111,111 - Building fire,0,1000,1000,8000,7000
19747,2013,Autumn,8/7/2013,1200 I 264 West N/A City of Audubon Park KY 40213,Vehicle Fire,131,131 - Passenger vehicle fire,0,2700,2700,2700,0
19799,2013,Autumn,8/7/2013,3810 VERMONT 1 City of Louisville KY 40211,Structure Fire,111,111 - Building fire,2000,5000,7000,40000,33000
19890,2013,Autumn,8/8/2013,535 E BROADWAY n/a City of Louisville KY 40202,Vehicle Fire,131,131 - Passenger vehicle fire,0,900,900,4000,3100
19979,2013,Autumn,8/9/2013,3391 YOUNG 106 City of Louisville KY 40211,Structure Fire,113,"113 - Cooking fire, confined to container",100,0,100,0,-100
19986,2013,Autumn,8/9/2013,2000 GARLAND N/A City of Louisville KY 40210,Vehicle Fire,131,131 - Passenger vehicle fire,0,2000,2000,2000,0
20050,2013,Autumn,8/10/2013,2411 MAPLE N/A City of Louisville KY 40211,Vehicle Fire,131,131 - Passenger vehicle fire,0,6000,6000,6000,0
20254,2013,Autumn,8/12/2013,409 E MUHAMMAD ALI 1606 City of Louisville KY 40202,Structure Fire,113,"113 - Cooking fire, confined to container",100,0,100,0,-100
20318,2013,Autumn,8/13/2013,719 S 23RD na City of Louisville KY 40211,Vehicle Fire,131,131 - Passenger vehicle fire,0,4500,4500,4500,0
20350,2013,Autumn,8/13/2013,302 CECIL na City of Louisville KY 40212,Structure Fire,111,111 - Building fire,200,0,200,39000,38800
20703,2013,Autumn,8/17/2013,S 43RD City of Louisville KY 40212,Outside Fire,151,"151 - Outside rubbish, trash or waste fire",0,1000,1000,1000,0
20715,2013,Autumn,8/17/2013,3316 NOE Building B City of Cambridge KY 40220,Vehicle Fire,131,131 - Passenger vehicle fire,50,2500,2550,2500,-50
20715,2013,Autumn,8/17/2013,3316 NOE Building B City of Cambridge KY 40220,Structure Fire,111,111 - Building fire,0,1500,1500,236550,235050
20629,2013,Autumn,8/17/2013,415 N 42ND na City of Louisville KY 40212,Structure Fire,111,111 - Building fire,5000,15000,20000,27000,7000
20645,2013,Autumn,8/17/2013,539 LOUIS COLEMAN JR 4 City of Louisville KY 40211,Structure Fire,111,111 - Building fire,0,100,100,80000,79900
20671,2013,Autumn,8/17/2013,1420 S 32ND n/a City of Louisville KY 40211,Structure Fire,113,"113 - Cooking fire, confined to container",600,600,1200,38500,37300
20795,2013,Autumn,8/18/2013,2109 GRAND N/A City of Louisville KY 40210,Outside Fire,151,"151 - Outside rubbish, trash or waste fire",0,200,200,7000,6800
20824,2013,Autumn,8/19/2013,1707 PRENTICE N/A City of Louisville KY 40210,Structure Fire,111,111 - Building fire,200,200,400,11850,11450
20826,2013,Autumn,8/19/2013,3434 GLENDALE n/a City of Louisville KY 40215,Structure Fire,111,111 - Building fire,2000,20000,22000,50040,28040
20908,2013,Autumn,8/20/2013,3028 PEALE n/a City of Kingsley KY 40205,Structure Fire,111,111 - Building fire,100,0,100,160000,159900
20909,2013,Autumn,8/20/2013,S 34TH City of Louisville KY 40212,Vehicle Fire,133,133 - Rail vehicle fire,0,10000,10000,10000,0
20942,2013,Autumn,8/20/2013,1814 STANDARD Kitchen City of Louisville KY 40210,Structure Fire,113,"113 - Cooking fire, confined to container",1000,500,1500,25000,23500
21070,2013,Autumn,8/21/2013,ROY WILKINS City of Louisville KY 40203,Vehicle Fire,131,131 - Passenger vehicle fire,0,1000,1000,2000,1000
21099,2013,Autumn,8/22/2013,2820 GARFIELD n/a City of Louisville KY 40212,Structure Fire,111,111 - Building fire,0,10000,10000,10000,0
21101,2013,Autumn,8/22/2013,3115 HENDON N/A City of Cambridge KY 40220,Vehicle Fire,130,"130 - Mobile property (vehicle) fire, other",0,3000,3000,3000,0
21114,2013,Autumn,8/22/2013,S 11TH City of Louisville KY 40203,Vehicle Fire,131,131 - Passenger vehicle fire,200,2000,2200,2000,-200
21169,2013,Autumn,8/22/2013,S 39TH City of Louisville KY 40211,Outside Fire,142,142 - Brush or brush-and-grass mixture fire,0,100,100,100,0
21190,2013,Autumn,8/22/2013,1452 S 9TH n/a City of Louisville KY 40208,Structure Fire,111,111 - Building fire,0,1000,1000,30000,29000
21241,2013,Autumn,8/23/2013,1264 I 264 West n/a City of Audubon Park KY 40213,Vehicle Fire,131,131 - Passenger vehicle fire,100,1000,1100,1000,-100
21256,2013,Autumn,8/23/2013,2001 TREVILIAN n/a City of Kingsley KY 40205,Structure Fire,111,111 - Building fire,0,500,500,250000,249500
21273,2013,Autumn,8/24/2013,UTAH City of Louisville KY 40215,Vehicle Fire,131,131 - Passenger vehicle fire,0,6000,6000,6000,0
21339,2013,Autumn,8/24/2013,170 N BELLAIRE N/A City of Louisville KY 40206,Structure Fire,111,111 - Building fire,0,100,100,200000,199900
21375,2013,Autumn,8/25/2013,1521 BELLAMY Bldg 3 City of Louisville KY 40208,Vehicle Fire,131,131 - Passenger vehicle fire,0,7500,7500,7500,0
21443,2013,Autumn,8/25/2013,BAIRD City of Louisville KY 40203,Outside Fire,151,"151 - Outside rubbish, trash or waste fire",0,1000,1000,400000,399000
21636,2013,Autumn,8/27/2013,1716 MAE STREET KIDD N/A City of Louisville KY 40211,Vehicle Fire,131,131 - Passenger vehicle fire,0,2000,2000,4000,2000
21644,2013,Autumn,8/27/2013,940 S 17th N/A City of Louisville KY 40210,Structure Fire,120,"120 - Fire in mobile prop. used as a fixed struc., other",0,500,500,2000,1500
21682,2013,Autumn,8/28/2013,13000 I 65 North N/A City of Audubon Park KY 40213,Vehicle Fire,132,132 - Road freight or transport vehicle fire,500,0,500,0,-500
21713,2013,Autumn,8/28/2013,921 S PRESTON N/A City of Louisville KY 40203,Structure Fire,111,111 - Building fire,200,300,500,1000,500
21726,2013,Autumn,8/28/2013,WOODBOURNE City of Kingsley KY 40205,Vehicle Fire,131,131 - Passenger vehicle fire,0,1500,1500,1500,0
21739,2013,Autumn,8/28/2013,304 CLIFFWOOD HILL N/A City of Louisville KY 40206,Outside Fire,162,162 - Outside equipment fire,250,0,250,0,-250
21828,2013,Autumn,8/29/2013,3706 KLONDIKE Building 1 City of Louisville KY 40218,Structure Fire,111,111 - Building fire,50,4000,4050,25000,20950
21849,2013,Autumn,8/29/2013,8021 CHRISTIAN 323 City of Bancroft KY 40222,Structure Fire,111,111 - Building fire,0,1500,1500,8109660,8108160
21898,2013,Autumn,8/30/2013,S 2ND City of Louisville KY 40202,Vehicle Fire,131,131 - Passenger vehicle fire,75,200,275,1500,1225
21913,2013,Autumn,8/30/2013,733 N HITE 2 City of Louisville KY 40206,Structure Fire,111,111 - Building fire,5000,10000,15000,95450,80450
21972,2013,Autumn,8/31/2013,1487 FRANKFORT N/A City of Louisville KY 40206,Vehicle Fire,131,131 - Passenger vehicle fire,0,5000,5000,5000,0
21983,2013,Autumn,8/31/2013,W MAIN City of Louisville KY 40212,Structure Fire,111,111 - Building fire,0,25000,25000,30000,5000
22009,2013,Autumn,8/31/2013,1443 S 9TH N/a City of Louisville KY 40208,Structure Fire,118,"118 - Trash or rubbish fire, contained",0,5000,5000,30000,25000
22091,2013,Autumn,8/31/2013,39 HILL NA City of Louisville KY 40204,Structure Fire,111,111 - Building fire,50000,200000,250000,600000,350000
22122,2013,Autumn,9/1/2013,2211 WILSON na City of Louisville KY 40210,Structure Fire,111,111 - Building fire,1000,20380,21380,20380,-1000
22126,2013,Autumn,9/1/2013,163 POPE N/A City of Louisville KY 40206,Structure Fire,111,111 - Building fire,0,2000,2000,110000,108000
22178,2013,Autumn,9/1/2013,552 CANNONS n/a City of Beechwood Village KY 40207,Structure Fire,111,111 - Building fire,0,2500,2500,750000,747500
22275,2013,Autumn,9/2/2013,938 W WHITNEY N/A City of Louisville KY 40215,Vehicle Fire,131,131 - Passenger vehicle fire,0,2000,2000,20000,18000
22292,2013,Autumn,9/2/2013,406 REG SMITH 204 City of Louisville KY 40208,Structure Fire,111,111 - Building fire,1000,0,1000,500000,499000
22376,2013,Autumn,9/3/2013,3400 TAYLOR gas station City of Louisville KY 40215,Vehicle Fire,131,131 - Passenger vehicle fire,0,1000,1000,1000,0
22471,2013,Autumn,9/4/2013,320 JOE CONWAY N/A City of Beechwood Village KY 40207,Structure Fire,111,111 - Building fire,1500,0,1500,40000000,39998500
22476,2013,Autumn,9/4/2013,4528 S 5TH n/a City of Louisville KY 40214,Outside Fire,162,162 - Outside equipment fire,0,200,200,200,0
22604,2013,Autumn,9/5/2013,2517 MAGAZINE 1 City of Louisville KY 40211,Structure Fire,113,"113 - Cooking fire, confined to container",1000,300,1300,30000,28700
22619,2013,Autumn,9/6/2013,1115 SAMUEL n/a City of Louisville KY 40204,Outside Fire,150,"150 - Outside rubbish fire, other",100,0,100,0,-100
22678,2013,Autumn,9/6/2013,4010 WOODRUFF n/a City of Louisville KY 40215,Structure Fire,111,111 - Building fire,0,500,500,40000,39500
22879,2013,Autumn,9/8/2013,S 7TH City of Louisville KY 40203,Outside Fire,151,"151 - Outside rubbish, trash or waste fire",0,60,60,60,0
22851,2013,Autumn,9/8/2013,315 W MUHAMMAD ALI NA City of Louisville KY 40202,Vehicle Fire,131,131 - Passenger vehicle fire,0,2500,2500,4600,2100
22885,2013,Autumn,9/9/2013,4219 VIRGINIA N/A City of Louisville KY 40211,Vehicle Fire,131,131 - Passenger vehicle fire,500,1500,2000,2500,500
22949,2013,Autumn,9/9/2013,CAMDEN City of Louisville KY 40215,Vehicle Fire,130,"130 - Mobile property (vehicle) fire, other",0,250,250,250,0
22990,2013,Autumn,9/9/2013,1516 HEPBURN 9 City of Louisville KY 40204,Structure Fire,111,111 - Building fire,0,100,100,500000,499900
23101,2013,Autumn,9/11/2013,748 S 23RD N/A City of Louisville KY 40211,Vehicle Fire,131,131 - Passenger vehicle fire,200,5000,5200,5000,-200
23131,2013,Autumn,9/11/2013,1200 MAPLE na City of Louisville KY 40210,Structure Fire,111,111 - Building fire,5000,2000,7000,600000,593000
23143,2013,Autumn,9/11/2013,HIKES City of Louisville KY 40218,Vehicle Fire,131,131 - Passenger vehicle fire,2000,1000,3000,1000,-2000
23256,2013,Autumn,9/12/2013,2825 GREENWOOD 9 City of Louisville KY 40211,Structure Fire,111,111 - Building fire,500,2000,2500,105390,102890
23292,2013,Autumn,9/13/2013,511 WARNOCK N/A City of Louisville KY 40217,Structure Fire,111,111 - Building fire,1000,3000,4000,3000,-1000
23445,2013,Autumn,9/14/2013,1316 S BROOK n\a City of Louisville KY 40208,Structure Fire,111,111 - Building fire,3000,50000,53000,110000,57000
23526,2013,Autumn,9/15/2013,4501 S 6TH 55 City of Louisville KY 40214,Structure Fire,112,112 - Fires in structure other than in a building,0,500,500,55000,54500
23529,2013,Autumn,9/15/2013,2333 W GAULBERT N/A City of Louisville KY 40210,Structure Fire,111,111 - Building fire,0,40000,40000,60000,20000
23529,2013,Autumn,9/15/2013,2329 W GAULBERT N/A City of Louisville KY 40210,Structure Fire,112,112 - Fires in structure other than in a building,0,2000,2000,60000,58000
23588,2013,Autumn,9/16/2013,1344 BEECH n/a City of Louisville KY 40211,Outside Fire,163,163 - Outside gas or vapor combustion explosion,100000,0,100000,1400000,1300000
23684,2013,Autumn,9/17/2013,1441 S 3RD n/a City of Louisville KY 40208,Structure Fire,111,111 - Building fire,700,2000,2700,600000,597300
23846,2013,Autumn,9/19/2013,1781 W LEE na City of Louisville KY 40210,Vehicle Fire,131,131 - Passenger vehicle fire,100,5000,5100,5000,-100
23860,2013,Autumn,9/19/2013,S BROOK City of Louisville KY 40202,Vehicle Fire,131,131 - Passenger vehicle fire,0,200,200,200,0
23890,2013,Autumn,9/19/2013,913 CAMDEN n/a City of Louisville KY 40215,Outside Fire,154,154 - Dumpster or other outside trash receptacle fire,0,200,200,2000,1800
23907,2013,Autumn,9/19/2013,445 S 32ND N/A City of Louisville KY 40212,Structure Fire,111,111 - Building fire,0,200,200,14520,14320
23970,2013,Autumn,9/20/2013,315 E BROADWAY N/A City of Louisville KY 40202,Vehicle Fire,131,131 - Passenger vehicle fire,0,300,300,300,0
24395,2013,Autumn,9/25/2013,1610 LUCIA Rear Lot City of Louisville KY 40204,Vehicle Fire,131,131 - Passenger vehicle fire,100,15000,15100,15000,-100
24435,2013,Autumn,9/25/2013,601 WIMBLETON 1 City of Louisville KY 40218,Structure Fire,111,111 - Building fire,1000,5000,6000,80000,74000
24616,2013,Autumn,9/27/2013,944 E MUHAMMAD ALI na City of Louisville KY 40204,Structure Fire,111,111 - Building fire,0,1000,1000,100000,99000
24720,2013,Autumn,9/28/2013,POPLAR LEVEL City of Audubon Park KY 40213,Vehicle Fire,131,131 - Passenger vehicle fire,0,1000,1000,1000,0
24773,2013,Autumn,9/29/2013,3173 S 2ND N/A City of Louisville KY 40208,FALSE,160,"160 - Special outside fire, other",200,0,200,NULL,NULL
24796,2013,Autumn,9/29/2013,200 ABRAHAM FLEXNER 426 City of Louisville KY 40202,Structure Fire,111,111 - Building fire,1000,0,1000,NULL,NULL
25210,2013,Autumn,10/3/2013,2029 S 41ST n/a City of Louisville KY 40211,Structure Fire,111,111 - Building fire,2000,1500,3500,15000,11500
25144,2013,Autumn,10/3/2013,470 N 29TH n/a City of Louisville KY 40212,Structure Fire,111,111 - Building fire,1000,7500,8500,28300,19800
25144,2013,Autumn,10/3/2013,468 N 29TH n/a City of Louisville KY 40212,Structure Fire,111,111 - Building fire,0,9000,9000,19500,10500
25233,2013,Autumn,10/4/2013,1649 BELMAR n/a City of Audubon Park KY 40213,Structure Fire,111,111 - Building fire,5000,50000,55000,70000,15000
25249,2013,Autumn,10/4/2013,1015 S PRESTON A City of Louisville KY 40203,Structure Fire,113,"113 - Cooking fire, confined to container",0,100,100,100,0
25301,2013,Autumn,10/4/2013,400 S 8TH 1410 City of Louisville KY 40203,Structure Fire,113,"113 - Cooking fire, confined to container",1000,0,1000,0,-1000
25660,2013,Autumn,10/8/2013,1141 S 32ND N/A City of Louisville KY 40211,Structure Fire,118,"118 - Trash or rubbish fire, contained",0,1000,1000,40000,39000
25757,2013,Autumn,10/9/2013,828 W EVELYN n/a City of Louisville KY 40215,Structure Fire,113,"113 - Cooking fire, confined to container",1000,1000,2000,1000,-1000
25881,2013,Autumn,10/11/2013,N 33RD City of Louisville KY 40212,Vehicle Fire,131,131 - Passenger vehicle fire,0,1500,1500,1500,0
25917,2013,Autumn,10/11/2013,W BRECKINRIDGE City of Louisville KY 40203,Vehicle Fire,131,131 - Passenger vehicle fire,0,1000,1000,1000,0
25926,2013,Autumn,10/11/2013,1006 BARRET n/a City of Louisville KY 40204,Structure Fire,111,111 - Building fire,0,100,100,200000,199900
26102,2013,Autumn,10/13/2013,1264 I 264 West n/a City of Audubon Park KY 40213,Vehicle Fire,131,131 - Passenger vehicle fire,0,12000,12000,12000,0
26136,2013,Autumn,10/13/2013,409 E MUHAMMAD ALI 310 City of Louisville KY 40202,Structure Fire,111,111 - Building fire,100,1000,1100,350000,348900
26224,2013,Autumn,10/14/2013,3901 TAYLOR n/a City of Louisville KY 40215,Vehicle Fire,131,131 - Passenger vehicle fire,0,800,800,3000,2200
26245,2013,Autumn,10/15/2013,3920 W MUHAMMAD ALI 1 City of Louisville KY 40212,Structure Fire,111,111 - Building fire,100,300,400,300,-100
26439,2013,Autumn,10/17/2013,743 WOODMORE n/a City of Louisville KY 40214,Structure Fire,111,111 - Building fire,0,2000,2000,150000,148000
26483,2013,Autumn,10/17/2013,3901 TAYLOR n/a City of Louisville KY 40215,Vehicle Fire,131,131 - Passenger vehicle fire,0,200,200,800,600
26609,2013,Autumn,10/19/2013,2608 W MADISON n/a City of Louisville KY 40211,Structure Fire,111,111 - Building fire,0,10000,10000,50000,40000
26645,2013,Autumn,10/19/2013,3917 7TH STREET n/a City of Louisville KY 40216,Vehicle Fire,131,131 - Passenger vehicle fire,0,1200,1200,1200,0
26690,2013,Autumn,10/19/2013,2409 BRADLEY 2 City of Louisville KY 40217,Structure Fire,111,111 - Building fire,100,0,100,0,-100
26725,2013,Autumn,10/20/2013,829 S SHELBY N/A City of Louisville KY 40203,Vehicle Fire,131,131 - Passenger vehicle fire,0,3000,3000,3000,0
26740,2013,Autumn,10/20/2013,906 MULBERRY n\a City of Louisville KY 40217,Structure Fire,111,111 - Building fire,0,5000,5000,100000,95000
26763,2013,Autumn,10/20/2013,159 POPE N/A City of Louisville KY 40206,Structure Fire,111,111 - Building fire,2000,5000,7000,180000,173000
26775,2013,Autumn,10/20/2013,1505 HEMLOCK N/A City of Louisville KY 40211,Structure Fire,111,111 - Building fire,0,18000,18000,18000,0
26784,2013,Autumn,10/21/2013,103 ROCK CLIFF 1 City of Louisville KY 40218,Structure Fire,113,"113 - Cooking fire, confined to container",0,400,400,45000,44600
26826,2013,Autumn,10/21/2013,5609 HALSTEAD n/a City of Audubon Park KY 40213,Structure Fire,113,"113 - Cooking fire, confined to container",3000,500,3500,93040,89540
26878,2013,Autumn,10/22/2013,3527 NORTHWESTERN None City of Louisville KY 40212,Structure Fire,111,111 - Building fire,10000,30000,40000,48000,8000
26894,2013,Autumn,10/22/2013,1172 CASTLEVALE 4 City of Louisville KY 40217,Structure Fire,111,111 - Building fire,3000,15000,18000,180000,162000
26913,2013,Autumn,10/22/2013,732 W MAIN N/A City of Louisville KY 40202,Structure Fire,111,111 - Building fire,0,500,500,2000000,1999500
26934,2013,Autumn,10/22/2013,1560 I 264 West N/A City of Cambridge KY 40220,Vehicle Fire,131,131 - Passenger vehicle fire,0,600,600,2000,1400
26991,2013,Autumn,10/23/2013,280 I 264 West N/A City of Louisville KY 40211,Vehicle Fire,131,131 - Passenger vehicle fire,0,2000,2000,2000,0
27062,2013,Autumn,10/24/2013,4117 S BROOK na City of Louisville KY 40214,Structure Fire,116,"116 - Fuel burner/boiler malfunction, fire confined",1200,0,1200,0,-1200
27076,2013,Autumn,10/24/2013,863 S 23RD n/a City of Louisville KY 40211,Outside Fire,151,"151 - Outside rubbish, trash or waste fire",0,1000,1000,1000,0
27076,2013,Autumn,10/24/2013,863 S 23RD n/a City of Louisville KY 40211,Outside Fire,151,"151 - Outside rubbish, trash or waste fire",0,1000,1000,1000,0
27156,2013,Autumn,10/25/2013,S 11TH City of Louisville KY 40203,Vehicle Fire,131,131 - Passenger vehicle fire,0,2906,2906,2906,0
27156,2013,Autumn,10/25/2013,S 11TH City of Louisville KY 40203,Vehicle Fire,131,131 - Passenger vehicle fire,0,2000,2000,5201,3201
27173,2013,Autumn,10/26/2013,511 S 5TH 1117 City of Louisville KY 40202,Structure Fire,111,111 - Building fire,300,1000,1300,1000,-300
27235,2013,Autumn,10/26/2013,322 S WENZEL N/A City of Louisville KY 40204,Vehicle Fire,131,131 - Passenger vehicle fire,0,1000,1000,3000,2000
27359,2013,Autumn,10/28/2013,825 S 33RD na City of Louisville KY 40211,Vehicle Fire,131,131 - Passenger vehicle fire,0,1500,1500,1500,0
27386,2013,Autumn,10/28/2013,4001 HERMAN N/A City of Louisville KY 40212,Structure Fire,111,111 - Building fire,0,3000,3000,1000000,997000
27433,2013,Autumn,10/28/2013,1052 BARDSTOWN N/A City of Louisville KY 40204,Structure Fire,111,111 - Building fire,0,15000,15000,200000,185000
27443,2013,Autumn,10/29/2013,544 E ORMSBY n/a City of Louisville KY 40203,Structure Fire,111,111 - Building fire,15000,69510,84510,69510,-15000
27465,2013,Autumn,10/29/2013,BRINKEY City of Louisville KY 40218,Structure Fire,111,111 - Building fire,1000,5000,6000,5000,-1000
27443,2013,Autumn,10/29/2013,600 E ORMSBY n/a City of Louisville KY 40203,Structure Fire,111,111 - Building fire,0,65830,65830,65830,0
27443,2013,Autumn,10/29/2013,542 E ORMSBY n/a City of Louisville KY 40203,Structure Fire,111,111 - Building fire,0,5000,5000,40000,35000
27443,2013,Autumn,10/29/2013,602 E ORMSBY n/a City of Louisville KY 40203,Structure Fire,111,111 - Building fire,0,8000,8000,47270,39270
27443,2013,Autumn,10/29/2013,604 E ORMSBY n/a City of Louisville KY 40203,Structure Fire,111,111 - Building fire,0,2000,2000,61380,59380
27608,2013,Autumn,10/30/2013,3437 NEWBURG 3 City of Louisville KY 40218,Structure Fire,113,"113 - Cooking fire, confined to container",3000,0,3000,0,-3000
27700,2013,Autumn,10/31/2013,422 N 38TH n/a City of Louisville KY 40212,Vehicle Fire,131,131 - Passenger vehicle fire,0,2500,2500,2500,0
27768,2013,Winter,11/1/2013,3901 TAYLORSVILLE n/a City of Cambridge KY 40220,Outside Fire,162,162 - Outside equipment fire,0,1500,1500,500000,498500
27837,2013,Winter,11/1/2013,660 I 64 N/A City of Louisville KY 40206,Vehicle Fire,131,131 - Passenger vehicle fire,1000,5000,6000,5000,-1000
27882,2013,Winter,11/2/2013,919 DENMARK n/a City of Louisville KY 40215,Structure Fire,111,111 - Building fire,5000,40000,45000,54360,9360
27888,2013,Winter,11/2/2013,2913 KINGS BRIDGE n/a City of Cambridge KY 40220,Outside Fire,160,"160 - Special outside fire, other",25,100,125,100,-25
27882,2013,Winter,11/2/2013,917 DENMARK n/a City of Louisville KY 40215,Structure Fire,111,111 - Building fire,0,4000,4000,59350,55350
28026,2013,Winter,11/3/2013,E WATER City of Louisville KY 40202,Vehicle Fire,131,131 - Passenger vehicle fire,0,1000,1000,1000,0
28049,2013,Winter,11/4/2013,2416 W CHESTNUT N/A City of Louisville KY 40211,Structure Fire,111,111 - Building fire,0,49830,49830,49830,0
28124,2013,Winter,11/5/2013,1126 W MUHAMMAD ALI N/A City of Louisville KY 40203,Vehicle Fire,131,131 - Passenger vehicle fire,0,3000,3000,3000,0
28283,2013,Winter,11/7/2013,5103 FAY n/a City of Louisville KY 40214,Structure Fire,111,111 - Building fire,2000,5000,7000,75000,68000
28313,2013,Winter,11/7/2013,654 S 23RD N/A City of Louisville KY 40211,Structure Fire,111,111 - Building fire,0,500,500,19880,19380
28513,2013,Winter,11/10/2013,2901 ENGLEWOOD N/A City of Cambridge KY 40220,Structure Fire,112,112 - Fires in structure other than in a building,300,0,300,0,-300
28525,2013,Winter,11/10/2013,1825 W OAK N/A City of Louisville KY 40210,Structure Fire,113,"113 - Cooking fire, confined to container",50,0,50,0,-50
28538,2013,Winter,11/10/2013,4418 TAYLOR 12 City of Louisville KY 40215,Structure Fire,121,121 - Fire in mobile home used as fixed residence,5000,20000,25000,20000,-5000
28571,2013,Winter,11/11/2013,E BRECKINRIDGE City of Louisville KY 40203,Structure Fire,112,112 - Fires in structure other than in a building,0,5000,5000,5000,0
28585,2013,Winter,11/11/2013,756 S SHELBY n/a City of Louisville KY 40203,Vehicle Fire,131,131 - Passenger vehicle fire,0,500,500,500,0
28593,2013,Winter,11/11/2013,3921 RIVER PARK n/a City of Louisville KY 40211,Vehicle Fire,131,131 - Passenger vehicle fire,0,3000,3000,3000,0
28628,2013,Winter,11/11/2013,109 N SHAWNEE n/a City of Louisville KY 40212,Structure Fire,113,"113 - Cooking fire, confined to container",300,1000,1300,45000,43700
28645,2013,Winter,11/12/2013,1568 S 9TH n/a City of Louisville KY 40208,Structure Fire,111,111 - Building fire,5000,15000,20000,15000,-5000
28662,2013,Winter,11/12/2013,1560 I 264 West N/A City of Kingsley KY 40205,Vehicle Fire,132,132 - Road freight or transport vehicle fire,0,25000,25000,25000,0
28710,2013,Winter,11/12/2013,717 E ORMSBY None City of Louisville KY 40203,Structure Fire,111,111 - Building fire,0,1000,1000,50570,49570
28782,2013,Winter,11/13/2013,700 ZORN 1 City of Louisville KY 40206,Structure Fire,113,"113 - Cooking fire, confined to container",0,75,75,250,175
28865,2013,Winter,11/14/2013,3544 BROCKTON 1 City of Cambridge KY 40220,Structure Fire,111,111 - Building fire,1800,2000,3800,606810,603010
28905,2013,Winter,11/15/2013,2806 POMEROY n/a City of Louisville KY 40218,Structure Fire,111,111 - Building fire,5000,10000,15000,140000,125000
28924,2013,Winter,11/15/2013,5027 FAY n/a City of Louisville KY 40214,Vehicle Fire,131,131 - Passenger vehicle fire,400,400,800,30000,29200
28963,2013,Winter,11/15/2013,134 CANNONS room City of Louisville KY 40206,Vehicle Fire,131,131 - Passenger vehicle fire,2000,55000,57000,55000,-2000
28980,2013,Winter,11/15/2013,2627 ROWAN N/A City of Louisville KY 40212,Structure Fire,111,111 - Building fire,0,24000,24000,24000,0
28980,2013,Winter,11/15/2013,2625 ROWAN N/A City of Louisville KY 40212,Structure Fire,111,111 - Building fire,0,2000,2000,24000,22000
28980,2013,Winter,11/15/2013,2629 ROWAN N/A City of Louisville KY 40212,Structure Fire,111,111 - Building fire,0,500,500,24000,23500
29117,2013,Winter,11/17/2013,4037 HENDERSON n/a City of Audubon Park KY 40213,Structure Fire,111,111 - Building fire,500,2000,2500,78700,76200
29122,2013,Winter,11/17/2013,DAYTON City of Beechwood Village KY 40207,Vehicle Fire,131,131 - Passenger vehicle fire,0,3000,3000,3000,0
29170,2013,Winter,11/18/2013,2430 MCKENDREE 202 City of Louisville KY 40211,Structure Fire,111,111 - Building fire,0,5000,5000,15000,10000
29370,2013,Winter,11/20/2013,654 S 23RD na City of Louisville KY 40211,Structure Fire,111,111 - Building fire,2500,5000,7500,24880,17380
29382,2013,Winter,11/20/2013,936 DIXIE na City of Louisville KY 40210,Vehicle Fire,131,131 - Passenger vehicle fire,0,1000,1000,1000,0
29407,2013,Winter,11/21/2013,1820 W HILL 2 City of Louisville KY 40210,Structure Fire,111,111 - Building fire,2500,5000,7500,66580,59080
29475,2013,Winter,11/21/2013,S 13TH City of Louisville KY 40210,Vehicle Fire,131,131 - Passenger vehicle fire,0,4000,4000,4000,0
29521,2013,Winter,11/22/2013,2502 NICHOLS VIEW N/A City of Louisville KY 40215,Vehicle Fire,131,131 - Passenger vehicle fire,0,4000,4000,4000,0
29645,2013,Winter,11/23/2013,1015 VINE 6 City of Louisville KY 40204,Vehicle Fire,131,131 - Passenger vehicle fire,0,500,500,3500,3000
29667,2013,Winter,11/24/2013,434 EASTERN Dennys City of Louisville KY 40217,Outside Fire,140,"140 - Natural vegetation fire, other",0,250,250,250,0
29698,2013,Winter,11/24/2013,3819 WEWOKA n/a City of Louisville KY 40212,Structure Fire,111,111 - Building fire,300,0,300,0,-300
29741,2013,Winter,11/25/2013,3038 ROSELAWN N/A City of Cambridge KY 40220,Structure Fire,111,111 - Building fire,20000,30000,50000,30000,-20000
29748,2013,Winter,11/25/2013,522 DENMARK N/A City of Louisville KY 40215,Structure Fire,111,111 - Building fire,10000,20000,30000,63300,33300
29766,2013,Winter,11/25/2013,1506 S 36TH na City of Louisville KY 40211,Structure Fire,113,"113 - Cooking fire, confined to container",100,0,100,0,-100
29780,2013,Winter,11/25/2013,2302 GLENMARY 2 City of Louisville KY 40204,Structure Fire,111,111 - Building fire,50000,100000,150000,400000,250000
29792,2013,Winter,11/25/2013,2737 W MARKET N/A City of Louisville KY 40212,Structure Fire,111,111 - Building fire,500,32200,32700,32200,-500
29792,2013,Winter,11/25/2013,2735 W MARKET N/A City of Louisville KY 40212,Structure Fire,111,111 - Building fire,0,3000,3000,28480,25480
29792,2013,Winter,11/25/2013,2739 W MARKET N/A City of Louisville KY 40212,Structure Fire,111,111 - Building fire,0,7500,7500,31999,24499
29793,2013,Winter,11/25/2013,3914 ELGIN N/A City of Louisville KY 40216,Structure Fire,113,"113 - Cooking fire, confined to container",400,0,400,0,-400
29821,2013,Winter,11/26/2013,1317 S 32ND N/A City of Louisville KY 40211,Outside Fire,163,163 - Outside gas or vapor combustion explosion,0,5000,5000,15000,10000
29835,2013,Winter,11/26/2013,6609 STRAWBERRY 4 City of Louisville KY 40214,Structure Fire,112,112 - Fires in structure other than in a building,75,0,75,NULL,NULL
29903,2013,Winter,11/27/2013,2112 DIXDALE N/A City of Louisville KY 40210,Structure Fire,111,111 - Building fire,3000,7000,10000,60000,50000
29917,2013,Winter,11/27/2013,325 ALGER N/A City of Louisville KY 40214,Structure Fire,111,111 - Building fire,10000,15000,25000,55000,30000
29927,2013,Winter,11/27/2013,231 E CHESTNUT na City of Louisville KY 40202,Vehicle Fire,131,131 - Passenger vehicle fire,0,1000,1000,1000,0
29934,2013,Winter,11/27/2013,1141 S 6TH 2 City of Louisville KY 40203,Structure Fire,111,111 - Building fire,10000,40000,50000,100000,50000
29977,2013,Winter,11/28/2013,1800 DIXIE N/A City of Louisville KY 40210,Vehicle Fire,131,131 - Passenger vehicle fire,0,1000,1000,2000,1000
29977,2013,Winter,11/28/2013,1802 ALGONQUIN N/A City of Louisville KY 40210,Structure Fire,111,111 - Building fire,0,2000,2000,100000,98000
29989,2013,Winter,11/28/2013,S 10TH City of Louisville KY 40203,Vehicle Fire,131,131 - Passenger vehicle fire,0,2500,2500,2500,0
30008,2013,Winter,11/28/2013,5103 SOUTHERN n/a City of Louisville KY 40214,Structure Fire,111,111 - Building fire,0,1500,1500,1500,0
30062,2013,Winter,11/29/2013,S 8TH City of Louisville KY 40202,Vehicle Fire,131,131 - Passenger vehicle fire,100,500,600,15000,14400
30118,2013,Winter,11/30/2013,N 22ND City of Louisville KY 40212,Vehicle Fire,131,131 - Passenger vehicle fire,0,1000,1000,1000,0
30169,2013,Winter,11/30/2013,945 S 5TH 909 City of Louisville KY 40203,Structure Fire,118,"118 - Trash or rubbish fire, contained",500,0,500,NULL,NULL
30249,2013,Winter,12/2/2013,S 2ND City of Louisville KY 40214,Vehicle Fire,131,131 - Passenger vehicle fire,500,3000,3500,3000,-500
30251,2013,Winter,12/2/2013,3322 W KENTUCKY N/A City of Louisville KY 40211,Structure Fire,113,"113 - Cooking fire, confined to container",0,500,500,20470,19970
30274,2013,Winter,12/2/2013,2118 MCCLOSKEY na City of Louisville KY 40210,Structure Fire,111,111 - Building fire,10000,20000,30000,20000,-10000
30378,2013,Winter,12/3/2013,2513 ST XAVIER None City of Louisville KY 40212,Vehicle Fire,131,131 - Passenger vehicle fire,0,500,500,500,0
30399,2013,Winter,12/3/2013,518 WAINWRIGHT None City of Louisville KY 40217,Structure Fire,111,111 - Building fire,1000,5000,6000,7000,1000
30486,2013,Winter,12/4/2013,2116 W KENTUCKY N/A City of Louisville KY 40210,Outside Fire,151,"151 - Outside rubbish, trash or waste fire",0,200,200,600,400
30488,2013,Winter,12/4/2013,1815 GREENWOOD N/A City of Louisville KY 40210,Structure Fire,111,111 - Building fire,0,500,500,45500,45000
30536,2013,Winter,12/5/2013,613 BAXTER n/a City of Louisville KY 40204,Structure Fire,111,111 - Building fire,50000,150000,200000,150000,-50000
30536,2013,Winter,12/5/2013,611 BAXTER 2 City of Louisville KY 40204,Structure Fire,111,111 - Building fire,20000,50000,70000,50000,-20000
30648,2013,Winter,12/6/2013,3648 MANSLICK 3 City of Louisville KY 40215,Structure Fire,111,111 - Building fire,0,1000,1000,60000,59000
30735,2013,Winter,12/7/2013,114 S 35TH n/a City of Louisville KY 40212,Structure Fire,111,111 - Building fire,0,1000,1000,20000,19000
30767,2013,Winter,12/7/2013,1910 S 35th N/A City of Louisville KY 40211,Structure Fire,111,111 - Building fire,5000,15000,20000,80000,60000
30874,2013,Winter,12/9/2013,38 NICHOLS na City of Louisville KY 40215,Structure Fire,111,111 - Building fire,7000,7000,14000,70000,56000
30907,2013,Winter,12/9/2013,1939 GOLDSMITH n/a City of Louisville KY 40218,Outside Fire,164,164 - Outside mailbox fire,100,0,100,0,-100
30953,2013,Winter,12/10/2013,1210 E WASHINGTON N/A City of Louisville KY 40206,Outside Fire,163,163 - Outside gas or vapor combustion explosion,0,2000,2000,500000,498000
30983,2013,Winter,12/10/2013,4025 FAYETTE NA City of Audubon Park KY 40213,Structure Fire,111,111 - Building fire,0,500,500,92700,92200
30990,2013,Winter,12/10/2013,2502 ST CECILIA N/A City of Louisville KY 40212,Structure Fire,111,111 - Building fire,0,1000,1000,1000,0
31064,2013,Winter,12/11/2013,2309 BOLLING na City of Louisville KY 40210,Structure Fire,111,111 - Building fire,3000,10000,13000,30900,17900
31064,2013,Winter,12/11/2013,2305 BOLLING na City of Louisville KY 40210,Structure Fire,111,111 - Building fire,0,1000,1000,32490,31490
31105,2013,Winter,12/12/2013,901 BAXTER n/a City of Louisville KY 40204,Outside Fire,154,154 - Dumpster or other outside trash receptacle fire,0,200,200,15200,15000
31105,2013,Winter,12/12/2013,901 BAXTER n/a City of Louisville KY 40204,Structure Fire,111,111 - Building fire,0,200,200,15200,15000
31108,2013,Winter,12/12/2013,911 ALGONQUIN na City of Louisville KY 40208,Vehicle Fire,131,131 - Passenger vehicle fire,0,3000,3000,3000,0
31177,2013,Winter,12/12/2013,769 S SHELBY N/A City of Louisville KY 40203,Structure Fire,111,111 - Building fire,0,500,500,500,0
31181,2013,Winter,12/12/2013,2336 W MUHAMMAD ALI None City of Louisville KY 40212,Vehicle Fire,131,131 - Passenger vehicle fire,0,2000,2000,2000,0
31197,2013,Winter,12/13/2013,2507 HIKES N/A City of Louisville KY 40218,Structure Fire,111,111 - Building fire,5000,25000,30000,92000,62000
31442,2013,Winter,12/16/2013,230 ALBANY N/A City of Louisville KY 40206,Structure Fire,111,111 - Building fire,200,1000,1200,3000,1800
31496,2013,Winter,12/16/2013,2704 W CHESTNUT N/A City of Louisville KY 40211,Structure Fire,111,111 - Building fire,5000,25000,30000,30000,0
31520,2013,Winter,12/17/2013,3033 BOAIRES N/A City of Cambridge KY 40220,Structure Fire,111,111 - Building fire,15000,30000,45000,100000,55000
31557,2013,Winter,12/17/2013,4032 TAYLORSVILLE Restaurant City of Cambridge KY 40220,Structure Fire,111,111 - Building fire,2000,10000,12000,500000,488000
31596,2013,Winter,12/18/2013,501 CREEL na City of Louisville KY 40208,Vehicle Fire,131,131 - Passenger vehicle fire,0,3000,3000,3000,0
31745,2013,Winter,12/19/2013,704 ZORN 2 City of Louisville KY 40206,Structure Fire,113,"113 - Cooking fire, confined to container",200,0,200,NULL,NULL
31781,2013,Winter,12/20/2013,2741 W MARKET n/a City of Louisville KY 40212,Structure Fire,111,111 - Building fire,0,12000,12000,27500,15500
31801,2013,Winter,12/20/2013,10 I 71 South N/A City of Louisville KY 40206,Vehicle Fire,132,132 - Road freight or transport vehicle fire,1000,75000,76000,75000,-1000
31808,2013,Winter,12/20/2013,4817 S 3RD 2 City of Louisville KY 40214,Structure Fire,111,111 - Building fire,10000,30000,40000,200000,160000
31851,2013,Winter,12/20/2013,3036 WILSON na City of Louisville KY 40211,Vehicle Fire,131,131 - Passenger vehicle fire,0,150,150,1200,1050
31953,2013,Winter,12/21/2013,545 S JACKSON Emergency Psych City of Louisville KY 40202,Structure Fire,118,"118 - Trash or rubbish fire, contained",100,0,100,NULL,NULL
32173,2013,Winter,12/23/2013,525 N 19TH n/a City of Louisville KY 40203,Structure Fire,111,111 - Building fire,200,0,200,30000,29800
32249,2013,Winter,12/24/2013,208 W KENWOOD n/a City of Louisville KY 40214,Structure Fire,111,111 - Building fire,5000,10000,15000,15000,0
32286,2013,Winter,12/25/2013,201 W TENNY N/A City of Louisville KY 40214,Structure Fire,111,111 - Building fire,500,1500,2000,94000,92000
32476,2013,Winter,12/27/2013,3808 RIVER PARK N/A City of Louisville KY 40211,Structure Fire,111,111 - Building fire,0,50000,50000,50000,0
32510,2013,Winter,12/27/2013,640 S SHELBY 201 City of Louisville KY 40202,Structure Fire,111,111 - Building fire,50,0,50,NULL,NULL
32730,2013,Winter,12/30/2013,2216 STANDARD na City of Louisville KY 40210,Structure Fire,111,111 - Building fire,0,100,100,100,0
144,2014,Winter,1/2/2014,1203 FISCHER n/a City of Louisville KY 40204,Outside Fire,151,"151 - Outside rubbish, trash or waste fire",0,100,100,100,0
163,2014,Winter,1/2/2014,517 E JEFFERSON 204 City of Louisville KY 40202,Structure Fire,118,"118 - Trash or rubbish fire, contained",1000,1000,2000,300000,298000
170,2014,Winter,1/2/2014,5115 NEW CUT na City of Louisville KY 40214,Structure Fire,111,111 - Building fire,0,1000,1000,300000,299000
297,2014,Winter,1/4/2014,726 DEARBORN N/A City of Louisville KY 40211,Structure Fire,111,111 - Building fire,2000,5000,7000,54850,47850
381,2014,Winter,1/4/2014,518 E BRECKINRIDGE N/A City of Louisville KY 40203,Structure Fire,111,111 - Building fire,10000,90000,100000,90000,-10000
564,2014,Winter,1/6/2014,2034 GOLDSMITH N/A City of Louisville KY 40218,Structure Fire,112,112 - Fires in structure other than in a building,2000,3000,5000,110000,105000
597,2014,Winter,1/6/2014,3801 POWELL n/a City of Louisville KY 40215,Structure Fire,111,111 - Building fire,5000,41300,46300,41300,-5000
641,2014,Winter,1/7/2014,4121 S 2ND N/A City of Louisville KY 40214,Structure Fire,111,111 - Building fire,5000,25000,30000,25000,-5000
646,2014,Winter,1/7/2014,2506 BOLLING N/A City of Louisville KY 40210,Structure Fire,111,111 - Building fire,2000,10000,12000,21470,9470
648,2014,Winter,1/7/2014,4156 SHERMAN NA City of Audubon Park KY 40213,Structure Fire,111,111 - Building fire,500,2000,2500,107500,105000
641,2014,Winter,1/7/2014,4125 S 2ND N/A City of Louisville KY 40214,Structure Fire,111,111 - Building fire,0,8000,8000,8000,0
806,2014,Winter,1/7/2014,5414 ROLLING RIDGE na City of Louisville KY 40214,Structure Fire,111,111 - Building fire,0,1000,1000,1000,0
939,2014,Winter,1/8/2014,E BROADWAY City of Louisville KY 40202,Vehicle Fire,132,132 - Road freight or transport vehicle fire,100000,175000,275000,225000,-50000
1134,2014,Winter,1/9/2014,3001 CRITTENDEN N/A City of Louisville KY 40209,Vehicle Fire,131,131 - Passenger vehicle fire,0,800,800,2500,1700
1149,2014,Winter,1/9/2014,2222 S 9TH N/A City of Louisville KY 40208,Structure Fire,111,111 - Building fire,1500,15000,16500,350000,333500
1173,2014,Winter,1/9/2014,2828 DESHLER NA City of Audubon Park KY 40213,Structure Fire,111,111 - Building fire,0,250,250,73900,73650
1180,2014,Winter,1/9/2014,409 E MUHAMMAD ALI 9th Floor City of Louisville KY 40202,Structure Fire,113,"113 - Cooking fire, confined to container",500,1000,1500,1000,-500
1229,2014,Winter,1/10/2014,205 E SOUTHLAND 2 City of Louisville KY 40214,Structure Fire,111,111 - Building fire,1000,25000,26000,137550,111550
1285,2014,Winter,1/10/2014,N 2ND City of Louisville KY 40202,Vehicle Fire,131,131 - Passenger vehicle fire,0,500,500,1500,1000
1453,2014,Winter,1/11/2014,3623 NICHOLS MEADOW na City of Louisville KY 40215,Structure Fire,111,111 - Building fire,0,100,100,80000,79900
1476,2014,Winter,1/12/2014,120 MCCREADY N/A City of Louisville KY 40206,Structure Fire,116,"116 - Fuel burner/boiler malfunction, fire confined",2000,5000,7000,230000,223000
1862,2014,Winter,1/16/2014,2031 S 41ST N/A City of Louisville KY 40211,Vehicle Fire,131,131 - Passenger vehicle fire,0,4000,4000,6000,2000
1878,2014,Winter,1/16/2014,610 W BRECKINRIDGE 2B City of Louisville KY 40203,Structure Fire,113,"113 - Cooking fire, confined to container",50,500,550,100000,99450
1941,2014,Winter,1/17/2014,1026 W MUHAMMAD ALI Apt City of Louisville KY 40203,Structure Fire,113,"113 - Cooking fire, confined to container",1000,1000,2000,40000,38000
1954,2014,Winter,1/17/2014,415 E MUHAMMAD ALI 811 City of Louisville KY 40202,Structure Fire,113,"113 - Cooking fire, confined to container",500,0,500,0,-500
2065,2014,Winter,1/19/2014,1334 MORTON n/a City of Louisville KY 40204,Outside Fire,161,161 - Outside storage fire,50,100,150,100,-50
2085,2014,Winter,1/19/2014,911 GRADE NA City of Audubon Park KY 40213,Vehicle Fire,131,131 - Passenger vehicle fire,0,2500,2500,2500,0
2105,2014,Winter,1/19/2014,2305 W MADISON N/A City of Louisville KY 40211,Structure Fire,111,111 - Building fire,0,15000,15000,65000,50000
2147,2014,Winter,1/20/2014,13080 I 65 North N/A City of Audubon Park KY 40213,Vehicle Fire,131,131 - Passenger vehicle fire,0,5000,5000,5000,0
2209,2014,Winter,1/20/2014,CARL City of Louisville KY 40215,Outside Fire,151,"151 - Outside rubbish, trash or waste fire",10,0,10,0,-10
2238,2014,Winter,1/21/2014,1341 S 20TH N/A City of Louisville KY 40210,Vehicle Fire,131,131 - Passenger vehicle fire,500,8000,8500,8000,-500
2322,2014,Winter,1/22/2014,1307 SOUTHGATE n/a City of Louisville KY 40215,Structure Fire,111,111 - Building fire,3000,5000,8000,60110,52110
2333,2014,Winter,1/22/2014,837 S 28TH N/A City of Louisville KY 40211,Structure Fire,111,111 - Building fire,0,5000,5000,25000,20000
2371,2014,Winter,1/22/2014,1340 S 1ST n/a City of Louisville KY 40208,Structure Fire,111,111 - Building fire,1000,5000,6000,200000,194000
2381,2014,Winter,1/22/2014,1135 S 2ND 201 City of Louisville KY 40203,Structure Fire,111,111 - Building fire,0,900,900,140000,139100
2398,2014,Winter,1/22/2014,4608 SOUTHERN 10 City of Louisville KY 40214,Structure Fire,111,111 - Building fire,10000,10000,20000,250000,230000
2598,2014,Winter,1/24/2014,729 S 41ST N/A City of Louisville KY 40211,Structure Fire,111,111 - Building fire,500,1500,2000,72680,70680
2879,2014,Winter,1/27/2014,2421 MAPLE N/A City of Louisville KY 40211,Structure Fire,111,111 - Building fire,0,10000,10000,25700,15700
2891,2014,Winter,1/27/2014,930 W CHESTNUT na City of Louisville KY 40203,Vehicle Fire,131,131 - Passenger vehicle fire,0,1000,1000,3000,2000
2901,2014,Winter,1/27/2014,228 POPE N/A City of Louisville KY 40206,Structure Fire,111,111 - Building fire,10000,30000,40000,100000,60000
2928,2014,Winter,1/28/2014,13080 I 264 East n/a City of Audubon Park KY 40213,Vehicle Fire,131,131 - Passenger vehicle fire,0,4000,4000,5000,1000
2949,2014,Winter,1/28/2014,S 44TH City of Louisville KY 40211,Outside Fire,151,"151 - Outside rubbish, trash or waste fire",0,100,100,100,0
2953,2014,Winter,1/28/2014,1030 WALTER n/a City of Louisville KY 40215,Vehicle Fire,131,131 - Passenger vehicle fire,300,3500,3800,4500,700
3144,2014,Winter,1/30/2014,1704 LIBERTY BELL 1 City of Louisville KY 40215,Structure Fire,113,"113 - Cooking fire, confined to container",500,0,500,0,-500
3447,2014,Spring,2/2/2014,921 E MADISON 2 City of Louisville KY 40204,Vehicle Fire,131,131 - Passenger vehicle fire,0,2000,2000,2000,0
3552,2014,Spring,2/3/2014,2644 CLEVELAND 26 City of Louisville KY 40206,Structure Fire,111,111 - Building fire,1000,1000,2000,50000,48000
3554,2014,Spring,2/3/2014,223 S 24TH N/A City of Louisville KY 40212,Structure Fire,111,111 - Building fire,0,1500,1500,65000,63500
3759,2014,Spring,2/5/2014,4203 LYNNBROOK N/A City of Cambridge KY 40220,Vehicle Fire,131,131 - Passenger vehicle fire,200,300,500,1500,1000
3769,2014,Spring,2/5/2014,S 4TH City of Louisville KY 40203,Vehicle Fire,131,131 - Passenger vehicle fire,0,2000,2000,2000,0
3799,2014,Spring,2/5/2014,3514 COLMAR N/A City of Louisville KY 40211,Vehicle Fire,131,131 - Passenger vehicle fire,0,100,100,10000,9900
3812,2014,Spring,2/6/2014,2702 VIRGINIA N/A City of Louisville KY 40211,Vehicle Fire,131,131 - Passenger vehicle fire,0,2000,2000,3500,1500
3881,2014,Spring,2/6/2014,2221 HALE na City of Louisville KY 40210,Structure Fire,111,111 - Building fire,2000,20000,22000,28110,6110
3974,2014,Spring,2/7/2014,1801 W MARKET NA City of Louisville KY 40203,Structure Fire,111,111 - Building fire,50000,150000,200000,150000,-50000
4004,2014,Spring,2/8/2014,2716 LAMONT N/A City of Kingsley KY 40205,Structure Fire,111,111 - Building fire,0,30000,30000,30000,0
4013,2014,Spring,2/8/2014,623 S 22ND N/A City of Louisville KY 40211,Structure Fire,111,111 - Building fire,2000,20000,22000,30150,8150
4060,2014,Spring,2/9/2014,121 I 64 West na City of Louisville KY 40212,Vehicle Fire,131,131 - Passenger vehicle fire,200,5000,5200,5000,-200
4101,2014,Spring,2/9/2014,2618 ROWAN N/A City of Louisville KY 40212,Structure Fire,111,111 - Building fire,50000,15000,65000,20000,-45000
4163,2014,Spring,2/10/2014,3502 HALE n/a City of Louisville KY 40211,Structure Fire,111,111 - Building fire,0,5000,5000,40760,35760
4290,2014,Spring,2/11/2014,2412 DUMESNIL N/a City of Louisville KY 40210,Structure Fire,111,111 - Building fire,500,22000,22500,35000,12500
4290,2014,Spring,2/11/2014,2414 DUMESNIL N/A City of Louisville KY 40210,Structure Fire,111,111 - Building fire,0,1000,1000,35000,34000
4403,2014,Spring,2/13/2014,RIVER Orange Lot City of Louisville KY 40206,Vehicle Fire,131,131 - Passenger vehicle fire,0,500,500,500,0
4433,2014,Spring,2/13/2014,4522 SWAKO n/a City of Louisville KY 40216,Vehicle Fire,131,131 - Passenger vehicle fire,0,500,500,4000,3500
4470,2014,Spring,2/14/2014,1090 EASTERN n/a City of Louisville KY 40217,Structure Fire,111,111 - Building fire,100,500,600,365500,364900
4592,2014,Spring,2/15/2014,2307 RODMAN n/a City of Louisville KY 40208,Structure Fire,111,111 - Building fire,2000,20000,22000,20000,-2000
4712,2014,Spring,2/17/2014,2800 BRECKENRIDGE 0 City of Cambridge KY 40220,Structure Fire,111,111 - Building fire,1,0,1,0,-1
4806,2014,Spring,2/18/2014,634 S 42ND n/a City of Louisville KY 40211,Vehicle Fire,131,131 - Passenger vehicle fire,0,500,500,4000,3500
4814,2014,Spring,2/18/2014,744 S SHELBY n/a City of Louisville KY 40203,Structure Fire,111,111 - Building fire,1000,3000,4000,90000,86000
4912,2014,Spring,2/19/2014,2700 CRITTENDEN none City of Louisville KY 40209,Structure Fire,111,111 - Building fire,0,1000,1000,400000,399000
5096,2014,Spring,2/21/2014,751 S 12th N/A City of Louisville KY 40210,Structure Fire,115,"115 - Incinerator overload or malfunction, fire confined",40000,0,40000,500000,460000
5101,2014,Spring,2/22/2014,105 E MARKET na City of Louisville KY 40202,Vehicle Fire,131,131 - Passenger vehicle fire,0,250,250,1500,1250
5105,2014,Spring,2/22/2014,3419 RADIANCE n/a City of Cambridge KY 40220,Structure Fire,111,111 - Building fire,4000,30000,34000,70000,36000
5139,2014,Spring,2/22/2014,2326 GREENWOOD n/a City of Louisville KY 40210,Outside Fire,142,142 - Brush or brush-and-grass mixture fire,0,200,200,200,0
5144,2014,Spring,2/22/2014,3444 LARKWOOD n/a City of Louisville KY 40212,Outside Fire,142,142 - Brush or brush-and-grass mixture fire,0,1000,1000,1000,0
5177,2014,Spring,2/22/2014,2504 HOWARD N/A City of Louisville KY 40211,Structure Fire,111,111 - Building fire,2000,10000,12000,75000,63000
5188,2014,Spring,2/23/2014,1920 DEERWOOD n/a City of Kingsley KY 40205,Structure Fire,111,111 - Building fire,5000,25000,30000,300000,270000
5191,2014,Spring,2/23/2014,3721 CLIFF n/a City of Louisville KY 40215,Structure Fire,111,111 - Building fire,1000,10000,11000,48000,37000
5234,2014,Spring,2/23/2014,EASTERN City of Louisville KY 40217,Vehicle Fire,131,131 - Passenger vehicle fire,0,100,100,1000,900
5353,2014,Spring,2/25/2014,1315 S 6TH 2 City of Louisville KY 40208,Structure Fire,111,111 - Building fire,0,500,500,200000,199500
5356,2014,Spring,2/25/2014,121 I 64 West None City of Louisville KY 40212,Vehicle Fire,131,131 - Passenger vehicle fire,0,1000,1000,1000,0
5442,2014,Spring,2/26/2014,2710 W Broadway n/a City of Louisville KY 40211,Outside Fire,162,162 - Outside equipment fire,1500,0,1500,0,-1500
5519,2014,Spring,2/27/2014,4105 LAURELWOOD n/a City of Cambridge KY 40220,Structure Fire,111,111 - Building fire,2000,0,2000,0,-2000
5560,2014,Spring,2/28/2014,1001 BAXTER n/a City of Louisville KY 40204,Structure Fire,111,111 - Building fire,0,2500,2500,400000,397500
5561,2014,Spring,2/28/2014,2801 RAINBOW N/A City of Louisville KY 40206,Structure Fire,111,111 - Building fire,400,2500,2900,891190,888290
5598,2014,Spring,2/28/2014,1311 SOUTHGATE none City of Louisville KY 40215,Outside Fire,143,143 - Grass fire,0,500,500,50000,49500
5656,2014,Spring,3/1/2014,1015 MAGAZINE basement City of Louisville KY 40203,Structure Fire,116,"116 - Fuel burner/boiler malfunction, fire confined",500,0,500,0,-500
5686,2014,Spring,3/1/2014,2415 NORTHWESTERN n/a City of Louisville KY 40212,Structure Fire,111,111 - Building fire,1000,10000,11000,25500,14500
5713,2014,Spring,3/2/2014,116 E BURNETT 2 City of Louisville KY 40208,Structure Fire,111,111 - Building fire,15000,50000,65000,101650,36650
5750,2014,Spring,3/2/2014,2222 EDDY N/A City of Louisville KY 40212,Structure Fire,111,111 - Building fire,1000,0,1000,27400,26400
5812,2014,Spring,3/3/2014,1540 BERRY na City of Louisville KY 40215,Structure Fire,111,111 - Building fire,10000,30000,40000,100000,60000
5812,2014,Spring,3/3/2014,1540 BERRY na City of Louisville KY 40215,Structure Fire,111,111 - Building fire,0,3000,3000,100000,97000
5852,2014,Spring,3/4/2014,4307 LARKWOOD 2 City of Louisville KY 40212,Structure Fire,111,111 - Building fire,20000,50000,70000,74380,4380
5859,2014,Spring,3/4/2014,1155 EASTERN n/a City of Louisville KY 40217,Structure Fire,111,111 - Building fire,100,0,100,0,-100
5880,2014,Spring,3/4/2014,3301 NEWBURG N/A City of Louisville KY 40218,Vehicle Fire,131,131 - Passenger vehicle fire,0,2500,2500,2500,0
5985,2014,Spring,3/5/2014,1522 RUFER n/a City of Louisville KY 40204,Vehicle Fire,131,131 - Passenger vehicle fire,0,1472,1472,1472,0
6004,2014,Spring,3/5/2014,662 S BARBEE N/A City of Louisville KY 40217,Structure Fire,111,111 - Building fire,0,70000,70000,70000,0
6173,2014,Spring,3/7/2014,3209 DUVALLE N/A City of Louisville KY 40211,Structure Fire,113,"113 - Cooking fire, confined to container",100,0,100,0,-100
6195,2014,Spring,3/7/2014,N 26TH City of Louisville KY 40212,Vehicle Fire,131,131 - Passenger vehicle fire,0,2500,2500,2500,0
6412,2014,Spring,3/10/2014,960 S 4TH 310 City of Louisville KY 40203,Structure Fire,111,111 - Building fire,100,100,200,100,-100
6517,2014,Spring,3/11/2014,13301 I 65 North n/a City of Louisville KY 40217,Vehicle Fire,131,131 - Passenger vehicle fire,0,800,800,7000,6200
6558,2014,Spring,3/11/2014,3545 LENTZ back yard City of Louisville KY 40215,Outside Fire,143,143 - Grass fire,0,100,100,100,0
6630,2014,Spring,3/12/2014,S 11TH City of Louisville KY 40203,Vehicle Fire,131,131 - Passenger vehicle fire,200,1500,1700,2000,300
6682,2014,Spring,3/12/2014,N 28TH City of Louisville KY 40212,Vehicle Fire,131,131 - Passenger vehicle fire,0,500,500,500,0
6866,2014,Spring,3/15/2014,1935 OLIVE N/A City of Louisville KY 40210,Vehicle Fire,131,131 - Passenger vehicle fire,0,2000,2000,2000,0
6963,2014,Spring,3/15/2014,4013 W MARKET N/A City of Louisville KY 40212,Structure Fire,112,112 - Fires in structure other than in a building,100,500,600,500,-100
6966,2014,Spring,3/15/2014,2427 BARDSTOWN N/A City of Kingsley KY 40205,Vehicle Fire,131,131 - Passenger vehicle fire,0,5000,5000,6500,1500
6966,2014,Spring,3/15/2014,2427 BARDSTOWN N/A City of Kingsley KY 40205,Vehicle Fire,131,131 - Passenger vehicle fire,0,3000,3000,10000,7000
7038,2014,Spring,3/16/2014,3524 BROCKTON n/a City of Cambridge KY 40220,Outside Fire,151,"151 - Outside rubbish, trash or waste fire",0,3000,3000,4500,1500
7056,2014,Spring,3/16/2014,1724 WILLIAM E SUMMERS III N/A City of Louisville KY 40211,Structure Fire,113,"113 - Cooking fire, confined to container",0,1000,1000,50000,49000
7100,2014,Spring,3/17/2014,4105 W Market 0 City of Louisville KY 40212,Structure Fire,111,111 - Building fire,3000,25000,28000,60000,32000
7159,2014,Spring,3/17/2014,4136 W BROADWAY n/a City of Louisville KY 40211,Structure Fire,111,111 - Building fire,500,1500,2000,70000,68000
7327,2014,Spring,3/19/2014,2431 W BROADWAY n/a City of Louisville KY 40211,Structure Fire,112,112 - Fires in structure other than in a building,300,300,600,300,-300
7330,2014,Spring,3/19/2014,2431 W BROADWAY 0 City of Louisville KY 40211,Outside Fire,160,"160 - Special outside fire, other",1000,1000,2000,1000,-1000
7350,2014,Spring,3/19/2014,4130 TAYLOR n/a City of Louisville KY 40215,Structure Fire,118,"118 - Trash or rubbish fire, contained",0,1000,1000,10000,9000
7365,2014,Spring,3/20/2014,300BLK W FLORENCE n/a City of Louisville KY 40214,Vehicle Fire,131,131 - Passenger vehicle fire,0,1500,1500,2000,500
7467,2014,Spring,3/21/2014,2615 W JEFFERSON N/A City of Louisville KY 40212,Structure Fire,111,111 - Building fire,1000,10000,11000,24000,13000
7517,2014,Spring,3/21/2014,1926 BANK N/A City of Louisville KY 40203,Structure Fire,111,111 - Building fire,30000,33470,63470,33470,-30000
7517,2014,Spring,3/21/2014,1930 BANK N/A City of Louisville KY 40203,Structure Fire,111,111 - Building fire,0,25000,25000,39110,14110
7517,2014,Spring,3/21/2014,1924 BANK N/A City of Louisville KY 40203,Structure Fire,111,111 - Building fire,0,2000,2000,30150,28150
7539,2014,Spring,3/22/2014,1935 GARDINER F106 City of Kingsley KY 40205,Structure Fire,111,111 - Building fire,50,1500,1550,300000,298450
7562,2014,Spring,3/22/2014,1518 W MUHAMMAD ALI 3 City of Louisville KY 40203,Structure Fire,111,111 - Building fire,500,500,1000,200000,199000
7571,2014,Spring,3/22/2014,2622 W BROADWAY N/A City of Louisville KY 40211,Structure Fire,111,111 - Building fire,0,5000,5000,35000,30000
7594,2014,Spring,3/22/2014,501 WIMBLETON 7 City of Louisville KY 40218,Structure Fire,111,111 - Building fire,2000,6000,8000,400000,392000
7596,2014,Spring,3/22/2014,1449 OLIVE N/A City of Louisville KY 40210,Vehicle Fire,131,131 - Passenger vehicle fire,0,2000,2000,5500,3500
7600,2014,Spring,3/22/2014,TAYLORSVILLE City of Cambridge KY 40220,Vehicle Fire,131,131 - Passenger vehicle fire,0,2500,2500,2500,0
7613,2014,Spring,3/22/2014,4017 LENTZ n/a City of Louisville KY 40215,Structure Fire,111,111 - Building fire,0,100,100,58890,58790
7632,2014,Spring,3/22/2014,129 N 26TH n/a City of Louisville KY 40212,Structure Fire,111,111 - Building fire,0,3000,3000,22500,19500
7645,2014,Spring,3/23/2014,N 19TH City of Louisville KY 40203,Outside Fire,151,"151 - Outside rubbish, trash or waste fire",0,1000,1000,150000,149000
7645,2014,Spring,3/23/2014,N 19TH City of Louisville KY 40203,Outside Fire,151,"151 - Outside rubbish, trash or waste fire",0,1000,1000,150000,149000
7669,2014,Spring,3/23/2014,1410 CATALPA 2 City of Louisville KY 40211,Structure Fire,111,111 - Building fire,50,0,50,0,-50
7784,2014,Spring,3/24/2014,7312 MANSLICK n/a City of Louisville KY 40214,Structure Fire,111,111 - Building fire,1000,3000,4000,200000,196000
7800,2014,Spring,3/24/2014,4104 LEE n/a City of Audubon Park KY 40213,Structure Fire,111,111 - Building fire,5000,15000,20000,70000,50000
7814,2014,Spring,3/24/2014,1033 S JACKSON 4 City of Louisville KY 40203,Structure Fire,113,"113 - Cooking fire, confined to container",600,0,600,0,-600
7826,2014,Spring,3/25/2014,7312 MANSLICK n/a City of Louisville KY 40214,Structure Fire,111,111 - Building fire,20000,200000,220000,200000,-20000
7826,2014,Spring,3/25/2014,7310 MANSLICK n/a City of Louisville KY 40214,Structure Fire,111,111 - Building fire,0,4000,4000,200000,196000
7912,2014,Spring,3/26/2014,2513 DUNCAN n/a City of Louisville KY 40212,Vehicle Fire,131,131 - Passenger vehicle fire,0,5000,5000,5000,0
7957,2014,Spring,3/26/2014,402 MACLEAN n/a City of Louisville KY 40209,Structure Fire,111,111 - Building fire,0,200,200,1000000,999800
7974,2014,Spring,3/27/2014,FETTER City of Louisville KY 40217,Structure Fire,111,111 - Building fire,2000,10000,12000,203000,191000
7992,2014,Spring,3/27/2014,1340 S 3RD N/A City of Louisville KY 40208,Vehicle Fire,131,131 - Passenger vehicle fire,0,2875,2875,2875,0
8028,2014,Spring,3/27/2014,4135 VIRGINIA n/a City of Louisville KY 40211,Structure Fire,111,111 - Building fire,0,4000,4000,20000,16000
8104,2014,Spring,3/28/2014,4610 S 3RD n/a City of Louisville KY 40214,Structure Fire,111,111 - Building fire,15000,20000,35000,82000,47000
8154,2014,Spring,3/28/2014,1265 GOSS n\a City of Louisville KY 40217,Vehicle Fire,131,131 - Passenger vehicle fire,0,500,500,500,0
8279,2014,Spring,3/30/2014,1502 MOORE C City of Louisville KY 40210,Structure Fire,111,111 - Building fire,10000,10000,20000,10000,-10000
8311,2014,Spring,3/30/2014,3211 UTAH 3 City of Louisville KY 40215,Vehicle Fire,131,131 - Passenger vehicle fire,0,2000,2000,2000,0
8328,2014,Spring,3/31/2014,2023 LYTLE None City of Louisville KY 40203,Structure Fire,111,111 - Building fire,0,15000,15000,24000,9000
8353,2014,Spring,3/31/2014,1612 GARDINER N/A City of Kingsley KY 40205,Vehicle Fire,131,131 - Passenger vehicle fire,0,1400,1400,1400,0
8369,2014,Spring,3/31/2014,2911 TAYLOR 0 City of Louisville KY 40208,Structure Fire,111,111 - Building fire,1,1,2,1,-1
8384,2014,Spring,3/31/2014,PAYNE City of Louisville KY 40206,Vehicle Fire,131,131 - Passenger vehicle fire,0,1000,1000,5000,4000
8601,2014,Spring,4/3/2014,1426 S 28TH N/A City of Louisville KY 40211,Structure Fire,111,111 - Building fire,0,400,400,800,400
8604,2014,Spring,4/3/2014,1561 FERNWOOD 2 City of Kingsley KY 40205,Outside Fire,160,"160 - Special outside fire, other",0,500,500,500,0
8627,2014,Spring,4/3/2014,2419 LINDSAY 4 City of Louisville KY 40206,Structure Fire,111,111 - Building fire,1000,3000,4000,200000,196000
8713,2014,Spring,4/4/2014,7419 JUDY 1 City of Louisville KY 40214,Structure Fire,113,"113 - Cooking fire, confined to container",100,0,100,NULL,NULL
8775,2014,Spring,4/5/2014,1363 S 1ST 2 City of Louisville KY 40208,Structure Fire,111,111 - Building fire,0,1000,1000,130000,129000
8814,2014,Spring,4/5/2014,2108 W KENTUCKY N/A City of Louisville KY 40210,Vehicle Fire,131,131 - Passenger vehicle fire,0,3000,3000,3000,0
8908,2014,Spring,4/7/2014,4149 W MARKET n/a City of Louisville KY 40212,Structure Fire,111,111 - Building fire,0,20000,20000,85000,65000
9025,2014,Spring,4/8/2014,2526 W MADISON 708 City of Louisville KY 40211,Structure Fire,111,111 - Building fire,1000,1000,2000,1000000,998000
9028,2014,Spring,4/8/2014,27 COLLEGE N/A City of Louisville KY 40203,Structure Fire,111,111 - Building fire,500,1500,2000,15900,13900
9066,2014,Spring,4/8/2014,1377 S 20TH N/A City of Louisville KY 40210,Structure Fire,111,111 - Building fire,0,1000,1000,5000,4000
9134,2014,Spring,4/9/2014,S 6TH City of Louisville KY 40202,Vehicle Fire,131,131 - Passenger vehicle fire,0,1000,1000,2500,1500
9143,2014,Spring,4/9/2014,1700 BARDSTOWN N/A City of Kingsley KY 40205,Structure Fire,111,111 - Building fire,50,100,150,100,-50
9185,2014,Spring,4/10/2014,2803 YORKSHIRE N/A City of Cambridge KY 40220,Vehicle Fire,131,131 - Passenger vehicle fire,0,5000,5000,5000,0
9267,2014,Spring,4/11/2014,4005 W MUHAMMAD ALI n/a City of Louisville KY 40212,Structure Fire,111,111 - Building fire,0,2000,2000,60000,58000
9320,2014,Spring,4/11/2014,653 S 23RD N/A City of Louisville KY 40211,Vehicle Fire,131,131 - Passenger vehicle fire,0,3000,3000,3000,0
9335,2014,Spring,4/11/2014,S 29TH City of Louisville KY 40211,Vehicle Fire,131,131 - Passenger vehicle fire,0,3000,3000,3000,0
9538,2014,Spring,4/13/2014,300 S 1ST on sidewalk City of Louisville KY 40202,Outside Fire,140,"140 - Natural vegetation fire, other",0,100,100,100,0
9651,2014,Spring,4/14/2014,850 MIDWAY N/A City of Louisville KY 40211,Vehicle Fire,131,131 - Passenger vehicle fire,0,2000,2000,3000,1000
9666,2014,Spring,4/14/2014,1052 OAKWOOD n/a City of Louisville KY 40215,Vehicle Fire,131,131 - Passenger vehicle fire,0,3000,3000,3000,0
9745,2014,Spring,4/15/2014,3316 NOE 25 City of Cambridge KY 40220,Structure Fire,111,111 - Building fire,200,400,600,125000,124400
9794,2014,Spring,4/16/2014,601 W BRECKINRIDGE 3 City of Louisville KY 40203,Structure Fire,111,111 - Building fire,1000,4000,5000,150000,145000
9873,2014,Spring,4/17/2014,1349 S 20TH N/A City of Louisville KY 40210,Vehicle Fire,131,131 - Passenger vehicle fire,0,3000,3000,3000,0
9892,2014,Spring,4/17/2014,3728 TAYLORSVILLE n/a City of Cambridge KY 40220,Vehicle Fire,131,131 - Passenger vehicle fire,0,3000,3000,3500,500
9906,2014,Spring,4/17/2014,S 4TH City of Louisville KY 40203,Vehicle Fire,131,131 - Passenger vehicle fire,0,6000,6000,6000,0
9991,2014,Spring,4/18/2014,71 COLLEGE n/a City of Louisville KY 40203,Structure Fire,111,111 - Building fire,500,100,600,500000,499400
10027,2014,Spring,4/18/2014,3706 E WHEATMORE Building G City of Louisville KY 40215,Outside Fire,150,"150 - Outside rubbish fire, other",0,250,250,250,0
10073,2014,Spring,4/19/2014,819 PHILLIPS n/a City of Louisville KY 40209,Outside Fire,142,142 - Brush or brush-and-grass mixture fire,0,800,800,800000,799200
10074,2014,Spring,4/19/2014,329 N 20TH N/A City of Louisville KY 40203,Structure Fire,113,"113 - Cooking fire, confined to container",250,1000,1250,1000,-250
10083,2014,Spring,4/19/2014,2074 SHERWOOD N/A City of Kingsley KY 40205,Outside Fire,142,142 - Brush or brush-and-grass mixture fire,0,200,200,300000,299800
10110,2014,Spring,4/19/2014,4821 ST LEO n/a City of Louisville KY 40214,Structure Fire,111,111 - Building fire,0,800,800,55000,54200
10083,2014,Spring,4/19/2014,2074 SHERWOOD N/A City of Kingsley KY 40205,Outside Fire,142,142 - Brush or brush-and-grass mixture fire,0,200,200,300000,299800
10171,2014,Spring,4/20/2014,306 S 41ST None City of Louisville KY 40212,Outside Fire,160,"160 - Special outside fire, other",0,50,50,500,450
10206,2014,Spring,4/20/2014,6608 NORWAY na City of Louisville KY 40214,Structure Fire,111,111 - Building fire,1000,1000,2000,170000,168000
10332,2014,Spring,4/22/2014,2717 GARDINER n/a City of Kingsley KY 40205,Vehicle Fire,131,131 - Passenger vehicle fire,500,1000,1500,1000,-500
10425,2014,Spring,4/23/2014,725 E OAK n/a City of Louisville KY 40203,Structure Fire,111,111 - Building fire,15000,75000,90000,225000,135000
10425,2014,Spring,4/23/2014,725 E OAK n/a City of Louisville KY 40203,Structure Fire,111,111 - Building fire,0,1200,1200,15000,13800
10580,2014,Spring,4/24/2014,PRESTON City of Louisville KY 40217,Vehicle Fire,131,131 - Passenger vehicle fire,0,3200,3200,3200,0
10737,2014,Spring,4/26/2014,807 E BROADWAY N/A City of Louisville KY 40204,Structure Fire,111,111 - Building fire,8000,15000,23000,200000,177000
10758,2014,Spring,4/26/2014,405 E BRANDEIS None City of Louisville KY 40217,Vehicle Fire,131,131 - Passenger vehicle fire,0,6000,6000,6000,0
10906,2014,Spring,4/28/2014,3669 POWELL n/a City of Louisville KY 40215,Structure Fire,111,111 - Building fire,0,5000,5000,49040,44040
11050,2014,Spring,4/29/2014,28 COLONIAL OAKS 2 City of Louisville KY 40214,Structure Fire,111,111 - Building fire,1000,3000,4000,3000,-1000
11062,2014,Spring,4/29/2014,3031 DUMESNIL N/A City of Louisville KY 40211,Structure Fire,111,111 - Building fire,0,25000,25000,75000,50000
11066,2014,Spring,4/30/2014,DIXIE City of Louisville KY 40210,Vehicle Fire,131,131 - Passenger vehicle fire,0,5400,5400,5400,0
11074,2014,Spring,4/30/2014,1117 KAISER N/A City of Louisville KY 40211,Vehicle Fire,138,138 - Off-road vehicle or heavy equipment fire,3000,0,3000,0,-3000
11255,2014,Summer,5/1/2014,1440 S 32ND N/A City of Louisville KY 40211,Structure Fire,111,111 - Building fire,3000,30000,33000,50000,17000
11255,2014,Summer,5/1/2014,1438 S 32ND N/A City of Louisville KY 40211,Structure Fire,111,111 - Building fire,0,1000,1000,50000,49000
11292,2014,Summer,5/2/2014,2116 DATE N/A City of Louisville KY 40210,Structure Fire,111,111 - Building fire,0,24000,24000,24000,0
11318,2014,Summer,5/2/2014,700 CENTRAL paddock City of Louisville KY 40208,Structure Fire,113,"113 - Cooking fire, confined to container",1000,1000,2000,1000,-1000
11292,2014,Summer,5/2/2014,2114 DATE N/A City of Louisville KY 40210,Structure Fire,111,111 - Building fire,0,5000,5000,30000,25000
11292,2014,Summer,5/2/2014,2118 DATE N/A City of Louisville KY 40210,Structure Fire,111,111 - Building fire,0,5000,5000,25000,20000
11399,2014,Summer,5/3/2014,700 CENTRAL Paddock grill City of Louisville KY 40208,Structure Fire,113,"113 - Cooking fire, confined to container",500,0,500,50000,49500
11428,2014,Summer,5/3/2014,5405 WILDERNESS na City of Louisville KY 40214,Structure Fire,111,111 - Building fire,0,500,500,500,0
11428,2014,Summer,5/3/2014,143 WOODMORE na City of Louisville KY 40214,Structure Fire,111,111 - Building fire,0,100,100,500,400
11559,2014,Summer,5/4/2014,408 GEORGE UNSELD N/A City of Louisville KY 40203,Structure Fire,111,111 - Building fire,500,1500,2000,25000,23000
11740,2014,Summer,5/6/2014,1708 LANG N/A City of Louisville KY 40211,Vehicle Fire,131,131 - Passenger vehicle fire,0,2500,2500,4000,1500
11744,2014,Summer,5/6/2014,232 N CAMPBELL 0 City of Louisville KY 40206,Outside Fire,160,"160 - Special outside fire, other",1,0,1,0,-1
11823,2014,Summer,5/7/2014,1702 W KENTUCKY na City of Louisville KY 40210,Structure Fire,111,111 - Building fire,0,22920,22920,22920,0
11855,2014,Summer,5/7/2014,3710 E WHEATMORE Building H City of Louisville KY 40215,Structure Fire,111,111 - Building fire,1000,5000,6000,5000,-1000
11860,2014,Summer,5/7/2014,S 29TH City of Louisville KY 40212,Vehicle Fire,131,131 - Passenger vehicle fire,0,1000,1000,3500,2500
11823,2014,Summer,5/7/2014,1702 W KENTUCKY na City of Louisville KY 40210,Structure Fire,111,111 - Building fire,0,5000,5000,27060,22060
11893,2014,Summer,5/8/2014,2117 GRAND na City of Louisville KY 40210,Structure Fire,111,111 - Building fire,0,35760,35760,35760,0
11906,2014,Summer,5/8/2014,815 HUMLER N/A City of Louisville KY 40211,Structure Fire,111,111 - Building fire,0,10000,10000,10000,0
11935,2014,Summer,5/8/2014,810 BARRET n/a City of Louisville KY 40204,Vehicle Fire,131,131 - Passenger vehicle fire,0,500,500,1000,500
12061,2014,Summer,5/9/2014,240 I 264 West n/a City of Audubon Park KY 40213,Vehicle Fire,131,131 - Passenger vehicle fire,0,1500,1500,1500,0
12245,2014,Summer,5/11/2014,1050 LYNNHURST n/a City of Louisville KY 40215,Outside Fire,162,162 - Outside equipment fire,0,400,400,400,0
12315,2014,Summer,5/12/2014,1611 WILSON n/a City of Louisville KY 40210,Structure Fire,111,111 - Building fire,1000,15000,16000,27000,11000
12385,2014,Summer,5/12/2014,422 E OAK n\a City of Louisville KY 40203,Outside Fire,160,"160 - Special outside fire, other",0,2000,2000,2000,0
12315,2014,Summer,5/12/2014,1611 WILSON n/a City of Louisville KY 40210,Structure Fire,111,111 - Building fire,0,1000,1000,1000,0
12520,2014,Summer,5/14/2014,3203 BROWNSBORO garage City of Louisville KY 40206,Structure Fire,111,111 - Building fire,20000,20000,40000,20000,-20000
12594,2014,Summer,5/14/2014,1615 W MUHAMMAD ALI 6 City of Louisville KY 40203,Structure Fire,111,111 - Building fire,1000,2500,3500,150878,147378
12607,2014,Summer,5/14/2014,621 S 42ND none City of Louisville KY 40211,Vehicle Fire,131,131 - Passenger vehicle fire,250,2500,2750,2500,-250
12520,2014,Summer,5/14/2014,3203 BROWNSBORO garage City of Louisville KY 40206,Structure Fire,111,111 - Building fire,0,15000,15000,15000,0
12520,2014,Summer,5/14/2014,3203 BROWNSBORO garage City of Louisville KY 40206,Structure Fire,111,111 - Building fire,0,5000,5000,20000,15000
12687,2014,Summer,5/16/2014,1295 BARDSTOWN n/a City of Louisville KY 40204,Structure Fire,111,111 - Building fire,0,300,300,300,0
12780,2014,Summer,5/17/2014,1909 PEONY N/A City of Louisville KY 40211,Vehicle Fire,131,131 - Passenger vehicle fire,0,2000,2000,6000,4000
12801,2014,Summer,5/17/2014,1086 BICKNELL N/A City of Louisville KY 40215,Structure Fire,111,111 - Building fire,4000,10000,14000,71000,57000
12809,2014,Summer,5/17/2014,2838 TAYLOR n/a City of Louisville KY 40208,Structure Fire,111,111 - Building fire,1000,10000,11000,10000,-1000
12812,2014,Summer,5/17/2014,1029 BARDSTOWN C City of Louisville KY 40204,Structure Fire,116,"116 - Fuel burner/boiler malfunction, fire confined",0,600,600,300000,299400
12822,2014,Summer,5/17/2014,912 CAMDEN N/A City of Louisville KY 40215,Structure Fire,111,111 - Building fire,0,400,400,46000,45600
12839,2014,Summer,5/17/2014,WARNOCK City of Louisville KY 40208,Vehicle Fire,131,131 - Passenger vehicle fire,0,7000,7000,7000,0
12809,2014,Summer,5/17/2014,2836 TAYLOR n/a City of Louisville KY 40208,Structure Fire,111,111 - Building fire,0,1000,1000,10000,9000
12809,2014,Summer,5/17/2014,2836 TAYLOR n/a City of Louisville KY 40208,Structure Fire,111,111 - Building fire,0,200,200,200,0
12931,2014,Summer,5/18/2014,2320 ECTON N/A City of Louisville KY 40216,Structure Fire,113,"113 - Cooking fire, confined to container",500,0,500,120000,119500
12938,2014,Summer,5/18/2014,818 S 39TH N/A City of Louisville KY 40211,Structure Fire,111,111 - Building fire,0,2500,2500,47030,44530
13013,2014,Summer,5/19/2014,4700 S 3RD n/a City of Louisville KY 40214,Structure Fire,111,111 - Building fire,500,0,500,0,-500
13030,2014,Summer,5/19/2014,2732 VIRGINIA 3 City of Louisville KY 40211,Structure Fire,111,111 - Building fire,5000,10000,15000,100000,85000
13040,2014,Summer,5/19/2014,2639 LANDOR n/a City of Kingsley KY 40205,Vehicle Fire,131,131 - Passenger vehicle fire,0,2000,2000,3000,1000
13067,2014,Summer,5/20/2014,224 N 37TH n/a City of Louisville KY 40212,Structure Fire,111,111 - Building fire,0,2000,2000,75000,73000
13094,2014,Summer,5/20/2014,611 S 44TH 4 City of Louisville KY 40211,Outside Fire,161,161 - Outside storage fire,2000,1500,3500,5000,1500
13128,2014,Summer,5/20/2014,841 RIVER CREST 4 City of Louisville KY 40206,Structure Fire,113,"113 - Cooking fire, confined to container",500,200,700,50000,49300
13142,2014,Summer,5/21/2014,3123 RIVER PARK na City of Louisville KY 40211,Vehicle Fire,131,131 - Passenger vehicle fire,0,6000,6000,6000,0
13150,2014,Summer,5/21/2014,3111 HALE n/a City of Louisville KY 40211,Structure Fire,111,111 - Building fire,500,1500,2000,65000,63000
13213,2014,Summer,5/21/2014,ALGONQUIN City of Louisville KY 40210,Vehicle Fire,132,132 - Road freight or transport vehicle fire,0,500,500,10000,9500
13331,2014,Summer,5/23/2014,S 45TH City of Louisville KY 40211,Vehicle Fire,131,131 - Passenger vehicle fire,0,18000,18000,18000,0
13382,2014,Summer,5/23/2014,545 S JACKSON 701 City of Louisville KY 40202,Structure Fire,118,"118 - Trash or rubbish fire, contained",50,2000,2050,2000,-50
13425,2014,Summer,5/23/2014,4418 ALLMOND n/a City of Louisville KY 40209,Structure Fire,111,111 - Building fire,2000,10000,12000,68600,56600
13331,2014,Summer,5/23/2014,S 45TH City of Louisville KY 40211,Vehicle Fire,131,131 - Passenger vehicle fire,0,5000,5000,5000,0
13482,2014,Summer,5/24/2014,134 E WOODLAWN n/a City of Louisville KY 40214,Vehicle Fire,131,131 - Passenger vehicle fire,0,2000,2000,8000,6000
13612,2014,Summer,5/25/2014,350 N 24TH N/A City of Louisville KY 40212,Structure Fire,111,111 - Building fire,0,15000,15000,20000,5000
13653,2014,Summer,5/26/2014,1818 DATE n/a City of Louisville KY 40210,Outside Fire,150,"150 - Outside rubbish fire, other",0,750,750,2000,1250
13759,2014,Summer,5/27/2014,833 S SHELBY N/A City of Louisville KY 40203,Structure Fire,111,111 - Building fire,5000,20000,25000,25000,0
13778,2014,Summer,5/28/2014,3314 ILLINOIS N/A City of Audubon Park KY 40213,Structure Fire,111,111 - Building fire,0,50000,50000,89000,39000
13799,2014,Summer,5/28/2014,W OAK City of Louisville KY 40203,Vehicle Fire,131,131 - Passenger vehicle fire,25,0,25,0,-25
13813,2014,Summer,5/28/2014,2909 FERN VALLEY na City of Audubon Park KY 40213,Structure Fire,111,111 - Building fire,3000,2000,5000,3000,-2000
13819,2014,Summer,5/28/2014,1011 S 32ND n/a City of Louisville KY 40211,Structure Fire,111,111 - Building fire,5000,15000,20000,30000,10000
13834,2014,Summer,5/28/2014,1201 BRASHEAR 12 City of Louisville KY 40210,Structure Fire,111,111 - Building fire,1000,1000,2000,1000,-1000
14009,2014,Summer,5/30/2014,1480 S 7TH NA City of Louisville KY 40208,Vehicle Fire,131,131 - Passenger vehicle fire,0,4000,4000,4000,0
14009,2014,Summer,5/30/2014,1480 S 7TH NA City of Louisville KY 40208,Outside Fire,162,162 - Outside equipment fire,0,5000,5000,5000,0
14009,2014,Summer,5/30/2014,1480 S 7TH NA City of Louisville KY 40208,Vehicle Fire,131,131 - Passenger vehicle fire,0,1000,1000,1000,0
14088,2014,Summer,5/31/2014,3628 STRATTON N/A City of Louisville KY 40211,Vehicle Fire,131,131 - Passenger vehicle fire,500,4000,4500,4000,-500
14089,2014,Summer,5/31/2014,909 E BROADWAY N/A City of Louisville KY 40204,Vehicle Fire,131,131 - Passenger vehicle fire,0,4000,4000,4000,0
14293,2014,Summer,6/2/2014,228 S HITE N/A City of Louisville KY 40206,Structure Fire,111,111 - Building fire,0,4000,4000,150000,146000
14387,2014,Summer,6/3/2014,3311 7TH STREET na City of Louisville KY 40216,Vehicle Fire,131,131 - Passenger vehicle fire,0,2000,2000,5000,3000
14670,2014,Summer,6/6/2014,1203 W MUHAMMAD ALI 1104 City of Louisville KY 40203,FALSE,442,442 - Overheated motor,150,0,150,NULL,NULL
14726,2014,Summer,6/7/2014,S 13TH City of Louisville KY 40203,FALSE,322,322 - Motor vehicle accident with injuries,0,8000,8000,8000,0
14732,2014,Summer,6/7/2014,448 SIMMONS Bldg 13 City of Louisville KY 40203,Structure Fire,111,111 - Building fire,250,0,250,NULL,NULL
14737,2014,Summer,6/7/2014,TAYLORSVILLE City of Cambridge KY 40220,Vehicle Fire,131,131 - Passenger vehicle fire,0,7000,7000,7000,0
14745,2014,Summer,6/7/2014,3201 LEITH 617 City of Louisville KY 40218,Structure Fire,111,111 - Building fire,300,0,300,NULL,NULL
14785,2014,Summer,6/7/2014,722 COKE NA City of Louisville KY 40203,Structure Fire,111,111 - Building fire,0,1000,1000,1000,0
14789,2014,Summer,6/7/2014,1210 CHEROKEE porch ceiling City of Louisville KY 40204,Structure Fire,111,111 - Building fire,0,2000,2000,300000,298000
14845,2014,Summer,6/8/2014,781 I 64 West N/A City of Louisville KY 40206,FALSE,322,322 - Motor vehicle accident with injuries,100,3000,3100,3000,-100
14871,2014,Summer,6/8/2014,7900 SHELBYVILLE n/a City of Bancroft KY 40222,Vehicle Fire,131,131 - Passenger vehicle fire,0,2500,2500,2500,0
14883,2014,Summer,6/8/2014,524 S 20TH na City of Louisville KY 40203,Structure Fire,111,111 - Building fire,0,250,250,40000,39750
14953,2014,Summer,6/9/2014,1352 LILLIAN none City of Louisville KY 40208,Structure Fire,111,111 - Building fire,2000,2000,4000,50000,46000
15054,2014,Summer,6/10/2014,1139 SAMUEL n/a City of Louisville KY 40204,Structure Fire,111,111 - Building fire,100,2000,2100,10000,7900
15163,2014,Summer,6/11/2014,560 I 64 East N/A City of Louisville KY 40206,Vehicle Fire,131,131 - Passenger vehicle fire,0,1000,1000,1000,0
15251,2014,Summer,6/12/2014,TAYLORSVILLE City of Kingsley KY 40205,FALSE,500,"500 - Service call, other",0,5000,5000,5000,0
15274,2014,Summer,6/13/2014,S 4TH City of Louisville KY 40202,Outside Fire,151,"151 - Outside rubbish, trash or waste fire",100,0,100,0,-100
15369,2014,Summer,6/14/2014,2132 GARLAND N/A City of Louisville KY 40211,Structure Fire,111,111 - Building fire,3000,10000,13000,29000,16000
15381,2014,Summer,6/14/2014,449 N 26TH NA City of Louisville KY 40212,Vehicle Fire,131,131 - Passenger vehicle fire,0,100,100,12120,12020
15395,2014,Summer,6/14/2014,1010 S SHELBY N/A City of Louisville KY 40203,Structure Fire,111,111 - Building fire,0,3000,3000,35000,32000
15395,2014,Summer,6/14/2014,1012 S SHELBY N/A City of Louisville KY 40203,Structure Fire,111,111 - Building fire,0,3000,3000,35000,32000
15473,2014,Summer,6/15/2014,2409 ROWAN n/a City of Louisville KY 40212,Structure Fire,118,"118 - Trash or rubbish fire, contained",0,400,400,100000,99600
15484,2014,Summer,6/15/2014,1028 MAGAZINE na City of Louisville KY 40203,Vehicle Fire,131,131 - Passenger vehicle fire,0,4500,4500,4500,0
15546,2014,Summer,6/15/2014,704 BERMUDA n/a City of Audubon Park KY 40213,Vehicle Fire,131,131 - Passenger vehicle fire,0,2000,2000,2000,0
15557,2014,Summer,6/15/2014,3415 BARDSTOWN back room City of Louisville KY 40218,Structure Fire,111,111 - Building fire,1000,0,1000,0,-1000
15571,2014,Summer,6/15/2014,S 15TH City of Louisville KY 40203,Vehicle Fire,131,131 - Passenger vehicle fire,0,21888,21888,21888,0
15546,2014,Summer,6/15/2014,704 BERMUDA n/a City of Audubon Park KY 40213,Vehicle Fire,131,131 - Passenger vehicle fire,0,1000,1000,2000,1000
15696,2014,Summer,6/16/2014,1649 BELMAR 1 City of Audubon Park KY 40213,Structure Fire,111,111 - Building fire,750,2000,2750,80000,77250
15705,2014,Summer,6/17/2014,809 S 8TH N/A City of Louisville KY 40203,Structure Fire,111,111 - Building fire,5000,1500,6500,1209480,1202980
15719,2014,Summer,6/17/2014,NEWBURG City of Kingsley KY 40205,Vehicle Fire,130,"130 - Mobile property (vehicle) fire, other",0,4000,4000,30000,26000
15770,2014,Summer,6/17/2014,126 E KINGSTON 2 City of Louisville KY 40214,Structure Fire,111,111 - Building fire,1000,3000,4000,3000,-1000
15795,2014,Summer,6/18/2014,1766 W OAK N/A City of Louisville KY 40210,Outside Fire,151,"151 - Outside rubbish, trash or waste fire",0,300,300,300,0
15873,2014,Summer,6/18/2014,2407 SHERRY na City of Louisville KY 40217,Structure Fire,111,111 - Building fire,5000,10000,15000,10000,-5000
15882,2014,Summer,6/18/2014,TAYLORSVILLE City of Cambridge KY 40220,FALSE,322,322 - Motor vehicle accident with injuries,0,1000,1000,1000,0
15898,2014,Summer,6/18/2014,1027 DIXIE na City of Louisville KY 40210,Structure Fire,111,111 - Building fire,2000,2000,4000,25290,21290
15948,2014,Summer,6/19/2014,2100 W CHESTNUT N/A City of Louisville KY 40211,Structure Fire,116,"116 - Fuel burner/boiler malfunction, fire confined",100,0,100,NULL,NULL
16101,2014,Summer,6/20/2014,2407 W Market na City of Louisville KY 40212,Structure Fire,111,111 - Building fire,10000,25000,35000,50000,15000
16133,2014,Summer,6/21/2014,2621 NORTHWESTERN na City of Louisville KY 40212,Structure Fire,111,111 - Building fire,0,300,300,78000,77700
16159,2014,Summer,6/21/2014,ALGONQUIN City of Louisville KY 40210,Vehicle Fire,131,131 - Passenger vehicle fire,0,15000,15000,15000,0
16218,2014,Summer,6/21/2014,1204 BARDSTOWN N/A City of Louisville KY 40204,Vehicle Fire,131,131 - Passenger vehicle fire,0,500,500,4000,3500
16295,2014,Summer,6/22/2014,932 S 1ST 1stFloorApt. City of Louisville KY 40203,Structure Fire,111,111 - Building fire,0,50000,50000,250000,200000
16299,2014,Summer,6/22/2014,808 EASTERN Suite 1 City of Louisville KY 40217,Structure Fire,111,111 - Building fire,0,200,200,4000000,3999800
16315,2014,Summer,6/22/2014,1279 S PRESTON 1 City of Louisville KY 40203,Structure Fire,111,111 - Building fire,100,0,100,0,-100
16330,2014,Summer,6/23/2014,3824 RIMONTE N/A City of Cambridge KY 40220,Structure Fire,111,111 - Building fire,20000,75000,95000,138000,43000
16446,2014,Summer,6/24/2014,2007 MAGAZINE 0 City of Louisville KY 40203,Structure Fire,111,111 - Building fire,0,1000,1000,25000,24000
16636,2014,Summer,6/26/2014,514 HEYWOOD n/a City of Louisville KY 40208,Structure Fire,111,111 - Building fire,200,800,1000,45000,44000
16756,2014,Summer,6/27/2014,200 ABRAHAM FLEXNER 4 City of Louisville KY 40202,Vehicle Fire,131,131 - Passenger vehicle fire,0,8000,8000,12000,4000
16756,2014,Summer,6/27/2014,200 ABRAHAM FLEXNER 4 City of Louisville KY 40202,Vehicle Fire,131,131 - Passenger vehicle fire,0,4000,4000,14000,10000
16822,2014,Summer,6/28/2014,2226 W JEFFERSON n/a City of Louisville KY 40212,Vehicle Fire,131,131 - Passenger vehicle fire,0,1500,1500,1500,0
16822,2014,Summer,6/28/2014,2226 W JEFFERSON n/a City of Louisville KY 40212,Structure Fire,111,111 - Building fire,0,3000,3000,60000,57000
16869,2014,Summer,6/28/2014,222 E WITHERSPOON 504 City of Louisville KY 40202,Structure Fire,113,"113 - Cooking fire, confined to container",25000,5000,30000,5000,-25000
16874,2014,Summer,6/28/2014,2740 FLEMING N/A City of Louisville KY 40206,Vehicle Fire,131,131 - Passenger vehicle fire,100,1000,1100,1500,400
16940,2014,Summer,6/29/2014,3041 WILSON N/A City of Louisville KY 40211,Structure Fire,111,111 - Building fire,100000,0,100000,0,-100000
16962,2014,Summer,6/29/2014,1010 MAGAZINE na City of Louisville KY 40203,Structure Fire,111,111 - Building fire,1000,5000,6000,50000,44000
17027,2014,Summer,6/30/2014,BOWMAN City of Kingsley KY 40205,FALSE,463,"463 - Vehicle accident, general cleanup",0,2000,2000,2000,0
17062,2014,Summer,6/30/2014,N 32ND City of Louisville KY 40212,Vehicle Fire,132,132 - Road freight or transport vehicle fire,150000,200000,350000,200000,-150000
17140,2014,Summer,7/1/2014,1680 I 264 East N/A City of Cambridge KY 40220,Vehicle Fire,131,131 - Passenger vehicle fire,0,350,350,3000,2650
17191,2014,Summer,7/2/2014,1020 MORGAN n/a City of Louisville KY 40217,Vehicle Fire,131,131 - Passenger vehicle fire,0,4600,4600,4600,0
17246,2014,Summer,7/2/2014,13080 I 65 North N/A City of Audubon Park KY 40213,Vehicle Fire,131,131 - Passenger vehicle fire,0,2000,2000,6000,4000
17251,2014,Summer,7/2/2014,1391 DIXIE N/A City of Louisville KY 40210,Structure Fire,111,111 - Building fire,0,25000,25000,25000,0
17300,2014,Summer,7/3/2014,1100 I 264 East N/A City of Louisville KY 40209,Vehicle Fire,132,132 - Road freight or transport vehicle fire,0,500,500,50000,49500
17416,2014,Summer,7/4/2014,2226 EASTVIEW n\a City of Kingsley KY 40205,Outside Fire,160,"160 - Special outside fire, other",300,0,300,0,-300
17426,2014,Summer,7/4/2014,2612 DUNCAN none City of Louisville KY 40212,Structure Fire,111,111 - Building fire,0,2000,2000,19000,17000
17427,2014,Summer,7/4/2014,2710 W MADISON N/A City of Louisville KY 40211,Structure Fire,111,111 - Building fire,0,19370,19370,19370,0
17438,2014,Summer,7/4/2014,3224 W MARKET none City of Louisville KY 40212,Structure Fire,111,111 - Building fire,0,100,100,37000,36900
17427,2014,Summer,7/4/2014,2708 W MADISON N/A City of Louisville KY 40211,Structure Fire,111,111 - Building fire,0,1000,1000,16130,15130
17513,2014,Summer,7/5/2014,2530 SLEVIN 308 City of Louisville KY 40212,Vehicle Fire,131,131 - Passenger vehicle fire,0,3000,3000,3000,0
17550,2014,Summer,7/5/2014,1301 S 28TH 103 City of Louisville KY 40211,Outside Fire,142,142 - Brush or brush-and-grass mixture fire,0,2000,2000,450000,448000
17571,2014,Summer,7/5/2014,1238 S 16TH 0 City of Louisville KY 40210,Structure Fire,111,111 - Building fire,100,0,100,0,-100
17579,2014,Summer,7/5/2014,4125 ALGONQUIN na City of Louisville KY 40211,Vehicle Fire,131,131 - Passenger vehicle fire,0,1000,1000,15000,14000
17612,2014,Summer,7/5/2014,3427 VETTER NA City of Louisville KY 40215,Structure Fire,111,111 - Building fire,0,500,500,500,0
17662,2014,Summer,7/6/2014,802 S 38TH na City of Louisville KY 40211,Structure Fire,111,111 - Building fire,100,500,600,67780,67180
17719,2014,Summer,7/6/2014,2700 CEDAR None City of Louisville KY 40212,Structure Fire,118,"118 - Trash or rubbish fire, contained",0,500,500,26000,25500
17844,2014,Summer,7/8/2014,3910 VERMONT n/a City of Louisville KY 40211,Structure Fire,111,111 - Building fire,2500,5000,7500,25000,17500
17867,2014,Summer,7/8/2014,34 COLONIAL OAKS 1 City of Louisville KY 40214,Structure Fire,111,111 - Building fire,0,300,300,100000,99700
17932,2014,Summer,7/8/2014,2877 REGAN Basement City of Louisville KY 40206,Structure Fire,111,111 - Building fire,0,1000,1000,300000,299000
17937,2014,Summer,7/9/2014,455 N 26TH n/a City of Louisville KY 40212,Vehicle Fire,131,131 - Passenger vehicle fire,100,4000,4100,12000,7900
17988,2014,Summer,7/9/2014,3719 GREENWOOD na City of Louisville KY 40211,Vehicle Fire,131,131 - Passenger vehicle fire,0,5000,5000,5000,0
18115,2014,Summer,7/11/2014,207 S PETERSON 2 City of Louisville KY 40206,Structure Fire,113,"113 - Cooking fire, confined to container",0,500,500,200000,199500
18198,2014,Summer,7/11/2014,666 S 35TH n/a City of Louisville KY 40211,Vehicle Fire,131,131 - Passenger vehicle fire,0,2500,2500,2500,0
18207,2014,Summer,7/12/2014,1600 GARLAND 608 City of Louisville KY 40210,Structure Fire,111,111 - Building fire,300,10000,10300,20000,9700
18216,2014,Summer,7/12/2014,1129 E ST CATHERINE n/a City of Louisville KY 40204,Structure Fire,111,111 - Building fire,20000,25000,45000,25000,-20000
18216,2014,Summer,7/12/2014,1129 E ST CATHERINE n/a City of Louisville KY 40204,Structure Fire,111,111 - Building fire,20000,25000,45000,25000,-20000
18216,2014,Summer,7/12/2014,1129 E ST CATHERINE n/a City of Louisville KY 40204,Structure Fire,111,111 - Building fire,500,20000,20500,20000,-500
18291,2014,Summer,7/13/2014,1751 DUMESNIL N/A City of Louisville KY 40210,Outside Fire,151,"151 - Outside rubbish, trash or waste fire",0,500,500,500,0
18396,2014,Summer,7/14/2014,1105 CAMDEN n/a City of Louisville KY 40215,Structure Fire,111,111 - Building fire,5000,5000,10000,10000,0
18450,2014,Summer,7/14/2014,2511 GRINSTEAD N/A City of Louisville KY 40206,Vehicle Fire,131,131 - Passenger vehicle fire,0,1200,1200,2500,1300
18565,2014,Summer,7/16/2014,2426 ELLIOTT na City of Louisville KY 40211,Structure Fire,111,111 - Building fire,0,2000,2000,18140,16140
18632,2014,Summer,7/16/2014,S 8TH City of Louisville KY 40202,Vehicle Fire,131,131 - Passenger vehicle fire,0,300,300,2000,1700
18645,2014,Summer,7/16/2014,2510 NORTHWESTERN N/A City of Louisville KY 40212,Outside Fire,161,161 - Outside storage fire,0,100,100,100,0
18693,2014,Summer,7/17/2014,3225 GOLDEN TURTLE N/A City of Louisville KY 40218,Vehicle Fire,131,131 - Passenger vehicle fire,0,2000,2000,2000,0
18696,2014,Summer,7/17/2014,1000 I 264 West NA City of Louisville KY 40214,Vehicle Fire,131,131 - Passenger vehicle fire,0,750,750,5000,4250
18748,2014,Summer,7/17/2014,1426 S 28TH N/A City of Louisville KY 40210,Outside Fire,151,"151 - Outside rubbish, trash or waste fire",0,100,100,20000,19900
18806,2014,Summer,7/18/2014,2012 PEABODY 2 City of Louisville KY 40218,Structure Fire,113,"113 - Cooking fire, confined to container",500,0,500,350000,349500
18910,2014,Summer,7/19/2014,2004 BANK N/A City of Louisville KY 40203,Structure Fire,112,112 - Fires in structure other than in a building,200,0,200,NULL,NULL
19059,2014,Summer,7/21/2014,N 24TH City of Louisville KY 40212,Outside Fire,154,154 - Dumpster or other outside trash receptacle fire,0,100,100,100,0
19138,2014,Summer,7/21/2014,S HANCOCK City of Louisville KY 40203,Vehicle Fire,131,131 - Passenger vehicle fire,0,12000,12000,18000,6000
19152,2014,Summer,7/22/2014,1435 S 3RD n/a City of Louisville KY 40208,Structure Fire,111,111 - Building fire,1000,5000,6000,100000,94000
19153,2014,Summer,7/22/2014,1532 S 4TH N/A City of Louisville KY 40208,Structure Fire,111,111 - Building fire,100000,150000,250000,250000,0
19198,2014,Summer,7/22/2014,S 3RD City of Louisville KY 40214,Vehicle Fire,131,131 - Passenger vehicle fire,500,2000,2500,2000,-500
19233,2014,Summer,7/22/2014,1385 S 3RD None City of Louisville KY 40208,FALSE,161,161 - Outside storage fire,100,0,100,NULL,NULL
19254,2014,Summer,7/23/2014,3938 TAYLORSVILLE N/A City of Cambridge KY 40220,Vehicle Fire,130,"130 - Mobile property (vehicle) fire, other",150,150,300,150,-150
19283,2014,Summer,7/23/2014,1036 PLACE VERT na City of Louisville KY 40203,Vehicle Fire,131,131 - Passenger vehicle fire,1000,1000,2000,1000,-1000
19290,2014,Summer,7/23/2014,2213 W MARKET n/a City of Louisville KY 40212,Structure Fire,111,111 - Building fire,500,15000,15500,20000,4500
19308,2014,Summer,7/23/2014,RIVER City of Louisville KY 40202,Vehicle Fire,131,131 - Passenger vehicle fire,100,100,200,100,-100
19381,2014,Summer,7/24/2014,S PRESTON City of Louisville KY 40202,Vehicle Fire,131,131 - Passenger vehicle fire,0,10000,10000,10000,0
19432,2014,Summer,7/25/2014,505 MONTANA na City of Louisville KY 40208,Structure Fire,111,111 - Building fire,5000,10000,15000,10000,-5000
19524,2014,Summer,7/26/2014,601 LOCUST N/A City of Louisville KY 40217,Vehicle Fire,131,131 - Passenger vehicle fire,0,11000,11000,11000,0
19600,2014,Summer,7/26/2014,2309 ALGONQUIN N/A City of Louisville KY 40210,Structure Fire,111,111 - Building fire,2000,8000,10000,58000,48000
19740,2014,Summer,7/27/2014,19 COLONIAL OAKS 2 City of Louisville KY 40214,Structure Fire,111,111 - Building fire,5000,10000,15000,10000,-5000
19745,2014,Summer,7/28/2014,1632 ALGONQUIN n/a City of Louisville KY 40210,Vehicle Fire,131,131 - Passenger vehicle fire,0,10000,10000,10000,0
19842,2014,Summer,7/29/2014,2306 GARLAND N/A City of Louisville KY 40211,Structure Fire,111,111 - Building fire,2000,2000,4000,26000,22000
19844,2014,Summer,7/29/2014,438 N 29TH N/A City of Louisville KY 40212,Structure Fire,111,111 - Building fire,1000,0,1000,0,-1000
19891,2014,Summer,7/29/2014,919 ALGONQUIN n/a City of Louisville KY 40208,Structure Fire,111,111 - Building fire,0,600,600,50000,49400
19931,2014,Summer,7/30/2014,3332 GREENWOOD N/A City of Louisville KY 40211,Structure Fire,111,111 - Building fire,500,500,1000,40000,39000
19984,2014,Summer,7/30/2014,2402 S PRESTON none City of Louisville KY 40217,Vehicle Fire,131,131 - Passenger vehicle fire,1000,1000,2000,1000,-1000
20044,2014,Summer,7/31/2014,2822 W MUHAMMAD ALI NA City of Louisville KY 40211,Vehicle Fire,131,131 - Passenger vehicle fire,0,1000,1000,1000,0
20045,2014,Summer,7/31/2014,2518 W MUHAMMAD ALI N/A City of Louisville KY 40211,Structure Fire,111,111 - Building fire,0,500,500,39600,39100
20047,2014,Summer,7/31/2014,2315 W MADISON 0 City of Louisville KY 40211,Outside Fire,151,"151 - Outside rubbish, trash or waste fire",100,0,100,0,-100
20058,2014,Summer,7/31/2014,3725 KLONDIKE 10 City of Cambridge KY 40220,Structure Fire,111,111 - Building fire,100,600,700,531000,530300
20096,2014,Summer,7/31/2014,712 CAMP None City of Louisville KY 40203,Vehicle Fire,131,131 - Passenger vehicle fire,0,2500,2500,2500,0
20107,2014,Summer,7/31/2014,1818 DATE N/A City of Louisville KY 40210,Structure Fire,111,111 - Building fire,500,7500,8000,7500,-500
20165,2014,Autumn,8/1/2014,S 20TH City of Louisville KY 40210,Vehicle Fire,131,131 - Passenger vehicle fire,0,1200,1200,1825,625
20200,2014,Autumn,8/1/2014,1700B CYPRESS N/A City of Louisville KY 40210,Structure Fire,111,111 - Building fire,500,1500,2000,4000,2000
20244,2014,Autumn,8/2/2014,4318 BROOKHAVEN N/A City of Cambridge KY 40220,Structure Fire,112,112 - Fires in structure other than in a building,1000,0,1000,0,-1000
20320,2014,Autumn,8/3/2014,1125 S 8TH na City of Louisville KY 40203,Vehicle Fire,131,131 - Passenger vehicle fire,500,1000,1500,3000,1500
20340,2014,Autumn,8/3/2014,2609 WILSON n/a City of Louisville KY 40211,Vehicle Fire,131,131 - Passenger vehicle fire,0,6000,6000,6000,0
20397,2014,Autumn,8/3/2014,4000 MIDLAND N/A City of Cambridge KY 40220,Outside Fire,154,154 - Dumpster or other outside trash receptacle fire,0,50,50,50,0
20442,2014,Autumn,8/4/2014,S 3RD City of Louisville KY 40208,Vehicle Fire,131,131 - Passenger vehicle fire,0,200,200,1200,1000
20490,2014,Autumn,8/4/2014,4130 WHEELER n/a City of Louisville KY 40215,Structure Fire,111,111 - Building fire,0,5000,5000,50000,45000
20529,2014,Autumn,8/5/2014,6335 STRAWBERRY n/a City of Louisville KY 40214,Vehicle Fire,131,131 - Passenger vehicle fire,0,600,600,600,0
20550,2014,Autumn,8/5/2014,1449 BARDSTOWN n/a City of Louisville KY 40204,Vehicle Fire,131,131 - Passenger vehicle fire,0,8000,8000,8000,0
20529,2014,Autumn,8/5/2014,6335 STRAWBERRY n/a City of Louisville KY 40214,Vehicle Fire,131,131 - Passenger vehicle fire,0,1500,1500,5000,3500
20626,2014,Autumn,8/6/2014,1305 BALDWIN n/a City of Louisville KY 40210,Structure Fire,111,111 - Building fire,200,0,200,NULL,NULL
20664,2014,Autumn,8/6/2014,2806 MARIGOLD na City of Audubon Park KY 40213,Structure Fire,111,111 - Building fire,0,1000,1000,75000,74000
20703,2014,Autumn,8/7/2014,2622 W BROADWAY N/A City of Louisville KY 40211,Structure Fire,111,111 - Building fire,0,5000,5000,35000,30000
20722,2014,Autumn,8/7/2014,512 S 28TH N/A City of Louisville KY 40211,Structure Fire,111,111 - Building fire,0,5000,5000,15370,10370
20737,2014,Autumn,8/7/2014,3670 WHEELER n/a City of Louisville KY 40215,Structure Fire,118,"118 - Trash or rubbish fire, contained",0,1000,1000,200000,199000
20781,2014,Autumn,8/8/2014,2419 W MAIN n/a City of Louisville KY 40212,Vehicle Fire,131,131 - Passenger vehicle fire,0,1300,1300,1300,0
20862,2014,Autumn,8/9/2014,204 S SHAWNEE Apt # 8 City of Louisville KY 40212,Structure Fire,111,111 - Building fire,2000,15000,17000,200000,183000
20891,2014,Autumn,8/9/2014,2735 W MAIN 2 City of Louisville KY 40212,Structure Fire,111,111 - Building fire,100,0,100,40000,39900
20952,2014,Autumn,8/9/2014,LOUIS COLEMAN JR City of Louisville KY 40211,Vehicle Fire,131,131 - Passenger vehicle fire,0,10000,10000,10000,0
20959,2014,Autumn,8/9/2014,414 MARRET None City of Louisville KY 40208,Structure Fire,111,111 - Building fire,1000,5000,6000,5000,-1000
21132,2014,Autumn,8/11/2014,S HANCOCK City of Louisville KY 40202,Structure Fire,118,"118 - Trash or rubbish fire, contained",0,1000,1000,25000,24000
21153,2014,Autumn,8/12/2014,4811 S 3RD 16 City of Louisville KY 40214,Structure Fire,111,111 - Building fire,0,200,200,300000,299800
21164,2014,Autumn,8/12/2014,807 E CHESTNUT parking lot City of Louisville KY 40204,Vehicle Fire,131,131 - Passenger vehicle fire,1000,2000,3000,2000,-1000
21225,2014,Autumn,8/12/2014,1602 MOORE 32 City of Louisville KY 40210,Structure Fire,111,111 - Building fire,0,200,200,200,0
21238,2014,Autumn,8/13/2014,3013 VIRGINIA n/a City of Louisville KY 40211,Vehicle Fire,131,131 - Passenger vehicle fire,0,3000,3000,3000,0
21330,2014,Autumn,8/13/2014,2352 ALEXANDER N/A City of Louisville KY 40217,Structure Fire,111,111 - Building fire,400,0,400,0,-400
21342,2014,Autumn,8/14/2014,504 DALE na City of Louisville KY 40214,Structure Fire,111,111 - Building fire,10000,30000,40000,80000,40000
21343,2014,Autumn,8/14/2014,553 LILLY n/a City of Louisville KY 40217,Outside Fire,151,"151 - Outside rubbish, trash or waste fire",0,500,500,500,0
21407,2014,Autumn,8/14/2014,N 24TH City of Louisville KY 40212,Vehicle Fire,131,131 - Passenger vehicle fire,0,2000,2000,2000,0
21486,2014,Autumn,8/15/2014,12TH STREET CONNECTOR City of Louisville KY 40203,Vehicle Fire,131,131 - Passenger vehicle fire,0,5000,5000,5000,0
21525,2014,Autumn,8/16/2014,126 E TENNY n/a City of Louisville KY 40214,Vehicle Fire,131,131 - Passenger vehicle fire,0,1000,1000,1000,0
21532,2014,Autumn,8/16/2014,4144 GREENWOOD n/a City of Louisville KY 40211,Structure Fire,111,111 - Building fire,0,10000,10000,32000,22000
21535,2014,Autumn,8/16/2014,4501 W BROADWAY N/A City of Louisville KY 40211,Vehicle Fire,131,131 - Passenger vehicle fire,0,10000,10000,10000,0
21559,2014,Autumn,8/16/2014,541 E ORMSBY n\a City of Louisville KY 40203,Structure Fire,111,111 - Building fire,2000,7500,9500,80000,70500
21576,2014,Autumn,8/16/2014,727 S 23RD N/A City of Louisville KY 40211,Structure Fire,111,111 - Building fire,0,22930,22930,22930,0
21651,2014,Autumn,8/17/2014,1317 MORGAN n/a City of Audubon Park KY 40213,Vehicle Fire,131,131 - Passenger vehicle fire,0,1500,1500,2000,500
21746,2014,Autumn,8/18/2014,1123 RAMMERS n/a City of Louisville KY 40204,Structure Fire,113,"113 - Cooking fire, confined to container",100,0,100,0,-100
21879,2014,Autumn,8/19/2014,4325 VERMONT na City of Louisville KY 40211,Outside Fire,162,162 - Outside equipment fire,0,5000,5000,5000,0
22006,2014,Autumn,8/21/2014,816 S 11TH 0 City of Louisville KY 40210,Vehicle Fire,132,132 - Road freight or transport vehicle fire,15000,500,15500,500,-15000
22034,2014,Autumn,8/21/2014,2230 WEBER N/A City of Kingsley KY 40205,Structure Fire,111,111 - Building fire,500,0,500,0,-500
22170,2014,Autumn,8/22/2014,631 ALGER na City of Louisville KY 40214,Structure Fire,111,111 - Building fire,10000,20000,30000,90000,60000
22282,2014,Autumn,8/23/2014,1045 EUCLID na City of Louisville KY 40208,Structure Fire,111,111 - Building fire,400,0,400,100,-300
22376,2014,Autumn,8/24/2014,2014 PORTLAND N/A City of Louisville KY 40203,Structure Fire,111,111 - Building fire,0,2000,2000,2000,0
22376,2014,Autumn,8/24/2014,2014 PORTLAND N/A City of Louisville KY 40203,Structure Fire,111,111 - Building fire,0,500,500,20000,19500
22454,2014,Autumn,8/25/2014,4211 LA SALLE outside City of Louisville KY 40215,Vehicle Fire,131,131 - Passenger vehicle fire,0,2000,2000,2000,0
22480,2014,Autumn,8/25/2014,BRENT City of Louisville KY 40204,Vehicle Fire,138,138 - Off-road vehicle or heavy equipment fire,0,1500,1500,1500,0
22485,2014,Autumn,8/25/2014,2116 HOWARD N/A City of Louisville KY 40211,Vehicle Fire,131,131 - Passenger vehicle fire,0,1000,1000,2044,1044
22544,2014,Autumn,8/26/2014,LESTER City of Louisville KY 40215,Vehicle Fire,131,131 - Passenger vehicle fire,250,4000,4250,4000,-250
22636,2014,Autumn,8/26/2014,3600 DUTCHMANS n/a City of Kingsley KY 40205,Structure Fire,111,111 - Building fire,20000,10000,30000,50000,20000
22658,2014,Autumn,8/27/2014,769 S CLAY n/a City of Louisville KY 40203,Vehicle Fire,131,131 - Passenger vehicle fire,0,250,250,5000,4750
22681,2014,Autumn,8/27/2014,436 S 10TH N/A City of Louisville KY 40203,Structure Fire,111,111 - Building fire,1000,5000,6000,300000,294000
22716,2014,Autumn,8/27/2014,80 VALLEY None City of Louisville KY 40204,Structure Fire,111,111 - Building fire,0,500,500,500,0
22785,2014,Autumn,8/28/2014,1122 RAMMERS n\a City of Louisville KY 40204,Structure Fire,111,111 - Building fire,1500,2000,3500,110000,106500
22907,2014,Autumn,8/29/2014,2510 LINDSAY B6 City of Louisville KY 40206,Structure Fire,111,111 - Building fire,300,0,300,250000,249700
22908,2014,Autumn,8/29/2014,E OAK City of Louisville KY 40203,Vehicle Fire,131,131 - Passenger vehicle fire,0,8500,8500,8500,0
23181,2014,Autumn,9/1/2014,415 E MUHAMMAD ALI 612 City of Louisville KY 40202,Structure Fire,111,111 - Building fire,2000,10000,12000,5000000,4988000
23222,2014,Autumn,9/2/2014,E WITHERSPOON City of Louisville KY 40202,Vehicle Fire,132,132 - Road freight or transport vehicle fire,200,5000,5200,150000,144800
23230,2014,Autumn,9/2/2014,I 264 East City of Cambridge KY 40220,Vehicle Fire,131,131 - Passenger vehicle fire,0,8000,8000,8000,0
23285,2014,Autumn,9/2/2014,3670 WHEELER N/A City of Louisville KY 40215,Outside Fire,151,"151 - Outside rubbish, trash or waste fire",25,400,425,300000,299575
23301,2014,Autumn,9/2/2014,4900BLK S 2ND n/a City of Louisville KY 40214,Vehicle Fire,130,"130 - Mobile property (vehicle) fire, other",0,100,100,100,0
23432,2014,Autumn,9/4/2014,644 BAXTER 2 nd floor City of Louisville KY 40204,Structure Fire,111,111 - Building fire,0,3000,3000,750000,747000
23449,2014,Autumn,9/4/2014,2211 DEARING N/A City of Louisville KY 40204,Structure Fire,122,"122 - Fire in motor home, camper, recreational vehicle",200,5000,5200,8000,2800
23460,2014,Autumn,9/4/2014,S 4TH City of Louisville KY 40202,Outside Fire,163,163 - Outside gas or vapor combustion explosion,0,2000,2000,2000,0
23516,2014,Autumn,9/4/2014,1064 HIGHLAND n/a City of Louisville KY 40204,Structure Fire,111,111 - Building fire,3000,20000,23000,93000,70000
23516,2014,Autumn,9/4/2014,1064 HIGHLAND n/a City of Louisville KY 40204,Structure Fire,111,111 - Building fire,0,2000,2000,87000,85000
23516,2014,Autumn,9/4/2014,1064 HIGHLAND n/a City of Louisville KY 40204,Vehicle Fire,131,131 - Passenger vehicle fire,0,1000,1000,2500,1500
23616,2014,Autumn,9/5/2014,NEWBURG City of Kingsley KY 40205,Vehicle Fire,131,131 - Passenger vehicle fire,500,5000,5500,5000,-500
23766,2014,Autumn,9/7/2014,I 264 East City of Cambridge KY 40220,Vehicle Fire,131,131 - Passenger vehicle fire,150,2000,2150,2000,-150
23788,2014,Autumn,9/7/2014,1100 TREVILIAN n/a City of Audubon Park KY 40213,Vehicle Fire,130,"130 - Mobile property (vehicle) fire, other",0,1000,1000,1000,0
23849,2014,Autumn,9/8/2014,1782 DIXDALE 301 City of Louisville KY 40210,Structure Fire,111,111 - Building fire,500,5000,5500,55560,50060
23882,2014,Autumn,9/8/2014,I 71 South n/a City of Beechwood Village KY 40207,Vehicle Fire,131,131 - Passenger vehicle fire,0,4000,4000,4000,0
23941,2014,Autumn,9/8/2014,1114 GARVIN 5 City of Louisville KY 40203,Structure Fire,111,111 - Building fire,1000,1000,2000,80000,78000
23989,2014,Autumn,9/9/2014,3531 VIRGINIA n/a City of Louisville KY 40211,Structure Fire,111,111 - Building fire,10000,25000,35000,50000,15000
24055,2014,Autumn,9/10/2014,2800 S FLOYD N/A City of Louisville KY 40209,Vehicle Fire,131,131 - Passenger vehicle fire,100,2000,2100,2000,-100
24055,2014,Autumn,9/10/2014,2800 S FLOYD N/A City of Louisville KY 40209,Vehicle Fire,131,131 - Passenger vehicle fire,0,2000,2000,8000,6000
24140,2014,Autumn,9/11/2014,2905 BANK na City of Louisville KY 40212,Structure Fire,111,111 - Building fire,0,10000,10000,27410,17410
24281,2014,Autumn,9/12/2014,1229 S 1ST n\a City of Louisville KY 40203,Structure Fire,111,111 - Building fire,10000,25000,35000,233000,198000
24370,2014,Autumn,9/13/2014,3611 W KENTUCKY na City of Louisville KY 40211,Structure Fire,111,111 - Building fire,300,5000,5300,25000,19700
24372,2014,Autumn,9/13/2014,2601 LE BLANC 10 City of Louisville KY 40206,Structure Fire,111,111 - Building fire,1000,10000,11000,250000,239000
24472,2014,Autumn,9/14/2014,S BROOK City of Louisville KY 40203,Vehicle Fire,131,131 - Passenger vehicle fire,0,4000,4000,4000,0
24486,2014,Autumn,9/14/2014,960 S 4TH 719 City of Louisville KY 40203,Structure Fire,111,111 - Building fire,0,2000,2000,70000,68000
24523,2014,Autumn,9/15/2014,1313 ST ANTHONY 6th City of Louisville KY 40204,Structure Fire,111,111 - Building fire,0,300,300,5000000,4999700
24571,2014,Autumn,9/15/2014,3301 INDIAN CREEK 4 City of Louisville KY 40218,Structure Fire,113,"113 - Cooking fire, confined to container",0,500,500,200000,199500
24741,2014,Autumn,9/17/2014,413 E MUHAMMAD ALI 1222 City of Louisville KY 40202,Structure Fire,113,"113 - Cooking fire, confined to container",0,100,100,750000,749900
24936,2014,Autumn,9/19/2014,2735 CRITTENDEN na City of Louisville KY 40209,Structure Fire,112,112 - Fires in structure other than in a building,0,5000,5000,5000,0
25041,2014,Autumn,9/20/2014,2002 ST LOUIS Kitchen City of Louisville KY 40210,Structure Fire,113,"113 - Cooking fire, confined to container",1500,500,2000,80000,78000
25051,2014,Autumn,9/20/2014,TAYLOR City of Louisville KY 40215,Vehicle Fire,131,131 - Passenger vehicle fire,100,2000,2100,2000,-100
25055,2014,Autumn,9/21/2014,1239 S BROOK n/a City of Louisville KY 40203,Vehicle Fire,131,131 - Passenger vehicle fire,0,3000,3000,3000,0
25058,2014,Autumn,9/21/2014,1235 S 16TH Basement City of Louisville KY 40210,Structure Fire,111,111 - Building fire,3000,3000,6000,29400,23400
25093,2014,Autumn,9/21/2014,3400 KERRY N/A City of Louisville KY 40218,Structure Fire,111,111 - Building fire,10000,20000,30000,160000,130000
25127,2014,Autumn,9/21/2014,S 28TH City of Louisville KY 40211,Structure Fire,112,112 - Fires in structure other than in a building,0,1000,1000,1000,0
25131,2014,Autumn,9/21/2014,911 GOSS 3 City of Louisville KY 40217,Structure Fire,111,111 - Building fire,0,500,500,200000,199500
25256,2014,Autumn,9/23/2014,2601 LINDSAY N/A City of Louisville KY 40206,Outside Fire,151,"151 - Outside rubbish, trash or waste fire",0,2000,2000,6000,4000
25256,2014,Autumn,9/23/2014,2601 LINDSAY N/A City of Louisville KY 40206,Outside Fire,151,"151 - Outside rubbish, trash or waste fire",0,2000,2000,6000,4000
25441,2014,Autumn,9/25/2014,1330 BARDSTOWN 1st City of Louisville KY 40204,Structure Fire,111,111 - Building fire,2000,2000,4000,350000,346000
25446,2014,Autumn,9/25/2014,1201 E OAK n/a City of Louisville KY 40204,Structure Fire,111,111 - Building fire,0,4000,4000,4000,0
25561,2014,Autumn,9/26/2014,E ST CATHERINE City of Louisville KY 40203,Vehicle Fire,131,131 - Passenger vehicle fire,1000,0,1000,NULL,NULL
25601,2014,Autumn,9/26/2014,2324 ST LOUIS n/a City of Louisville KY 40210,Structure Fire,111,111 - Building fire,10000,20000,30000,27550,-2450
25652,2014,Autumn,9/27/2014,3441 POWELL N/A City of Louisville KY 40215,Structure Fire,113,"113 - Cooking fire, confined to container",500,0,500,0,-500
25774,2014,Autumn,9/28/2014,3526 DUTCHMANS 0002 City of Kingsley KY 40205,Vehicle Fire,131,131 - Passenger vehicle fire,0,1500,1500,1500,0
25794,2014,Autumn,9/28/2014,7900 SHELBYVILLE n/a City of Bancroft KY 40222,Vehicle Fire,131,131 - Passenger vehicle fire,0,8000,8000,8000,0
25895,2014,Autumn,9/29/2014,I 264 East n/a City of Louisville KY 40211,Vehicle Fire,131,131 - Passenger vehicle fire,1500,0,1500,0,-1500
26182,2014,Autumn,10/2/2014,1240 MCKINLEY n/a City of Louisville KY 40217,Vehicle Fire,131,131 - Passenger vehicle fire,5000,10000,15000,10000,-5000
26088,2014,Autumn,10/2/2014,729 E OAK n/a City of Louisville KY 40203,Structure Fire,112,112 - Fires in structure other than in a building,0,10000,10000,10000,0
26273,2014,Autumn,10/3/2014,3007 DON DEE N/A City of Cambridge KY 40220,Structure Fire,111,111 - Building fire,2000,5000,7000,5000,-2000
26285,2014,Autumn,10/3/2014,4744 S RUTLAND n/a City of Louisville KY 40215,Structure Fire,111,111 - Building fire,1000,3000,4000,60000,56000
26298,2014,Autumn,10/4/2014,4610 S 3RD n/a City of Louisville KY 40214,Structure Fire,111,111 - Building fire,1000,15000,16000,15000,-1000
26357,2014,Autumn,10/4/2014,1391 DIXIE N/A City of Louisville KY 40210,Structure Fire,111,111 - Building fire,0,1000,1000,100000,99000
26421,2014,Autumn,10/5/2014,428 S 20TH B City of Louisville KY 40203,Structure Fire,111,111 - Building fire,1000,7000,8000,35590,27590
26515,2014,Autumn,10/6/2014,110 SOUTHWESTERN n/a City of Louisville KY 40212,Structure Fire,111,111 - Building fire,2000,20000,22000,123180,101180
26749,2014,Autumn,10/8/2014,5603 SHOREWOOD 1 City of Louisville KY 40214,Structure Fire,111,111 - Building fire,0,100,100,500000,499900
26668,2014,Autumn,10/8/2014,3810 DUNCAN na City of Louisville KY 40212,Vehicle Fire,131,131 - Passenger vehicle fire,0,2000,2000,2000,0
26673,2014,Autumn,10/8/2014,200 N 37TH n/a City of Louisville KY 40212,Vehicle Fire,131,131 - Passenger vehicle fire,0,3000,3000,3000,0
26686,2014,Autumn,10/8/2014,2129 W OAK NA City of Louisville KY 40210,Structure Fire,118,"118 - Trash or rubbish fire, contained",0,1000,1000,21400,20400
26704,2014,Autumn,10/8/2014,3013 MID DALE 1 City of Cambridge KY 40220,Structure Fire,111,111 - Building fire,5000,10000,15000,200000,185000
26798,2014,Autumn,10/9/2014,4309 ELLIOTT N/A City of Louisville KY 40211,Structure Fire,111,111 - Building fire,0,500,500,120000,119500
26858,2014,Autumn,10/10/2014,BRECKENRIDGE City of Cambridge KY 40220,Vehicle Fire,131,131 - Passenger vehicle fire,0,300,300,300,0
26912,2014,Autumn,10/10/2014,1214 S PRESTON 2 City of Louisville KY 40203,Structure Fire,113,"113 - Cooking fire, confined to container",1000,1000,2000,1000,-1000
26920,2014,Autumn,10/10/2014,3611 GRAND n/a City of Louisville KY 40211,Vehicle Fire,131,131 - Passenger vehicle fire,0,3000,3000,3000,0
26943,2014,Autumn,10/11/2014,3908 VERMONT na City of Louisville KY 40211,Structure Fire,111,111 - Building fire,1000,10000,11000,34040,23040
27052,2014,Autumn,10/12/2014,3201 GOLDEN TURTLE 202 City of Louisville KY 40218,Structure Fire,113,"113 - Cooking fire, confined to container",0,100,100,100,0
27097,2014,Autumn,10/12/2014,415 E MUHAMMAD ALI 1503 City of Louisville KY 40202,Structure Fire,113,"113 - Cooking fire, confined to container",0,500,500,1000000,999500
27098,2014,Autumn,10/12/2014,1166 S 41ST n/a City of Louisville KY 40211,Structure Fire,111,111 - Building fire,5000,10000,15000,40000,25000
27130,2014,Autumn,10/13/2014,600 TERMINAL 0 City of Louisville KY 40209,Vehicle Fire,131,131 - Passenger vehicle fire,0,1500,1500,1500,0
27362,2014,Autumn,10/15/2014,3542 GEORGETOWN 2 City of Louisville KY 40215,Structure Fire,113,"113 - Cooking fire, confined to container",400,0,400,3300000,3299600
27399,2014,Autumn,10/16/2014,400 ROY WILKINS na City of Louisville KY 40203,Structure Fire,111,111 - Building fire,1000,4000,5000,70000,65000
27462,2014,Autumn,10/16/2014,1700 ROSEWOOD #1 City of Louisville KY 40204,Structure Fire,111,111 - Building fire,0,4000,4000,300000,296000
27467,2014,Autumn,10/16/2014,664 S 26TH na City of Louisville KY 40211,Structure Fire,111,111 - Building fire,5000,10000,15000,17950,2950
27579,2014,Autumn,10/17/2014,3211 VIRGINIA NA City of Louisville KY 40211,Vehicle Fire,131,131 - Passenger vehicle fire,200,1200,1400,1200,-200
27601,2014,Autumn,10/18/2014,2723 ST XAVIER n/a City of Louisville KY 40212,Structure Fire,113,"113 - Cooking fire, confined to container",500,0,500,0,-500
27664,2014,Autumn,10/18/2014,131 RIVER n/a City of Louisville KY 40202,Structure Fire,111,111 - Building fire,0,200,200,300000,299800
27677,2014,Autumn,10/19/2014,222 E WITHERSPOON n/a City of Louisville KY 40202,Outside Fire,150,"150 - Outside rubbish fire, other",0,400,400,400,0
27734,2014,Autumn,10/19/2014,201 YORK 505 City of Louisville KY 40203,Structure Fire,118,"118 - Trash or rubbish fire, contained",0,50,50,500000,499950
27751,2014,Autumn,10/19/2014,CYPRESS City of Louisville KY 40210,Vehicle Fire,131,131 - Passenger vehicle fire,0,6000,6000,7000,1000
27760,2014,Autumn,10/19/2014,N 29TH City of Louisville KY 40212,Vehicle Fire,131,131 - Passenger vehicle fire,0,100,100,100,0
27764,2014,Autumn,10/20/2014,I 264 East N/A City of Louisville KY 40212,Vehicle Fire,131,131 - Passenger vehicle fire,0,2000,2000,8500,6500
27878,2014,Autumn,10/21/2014,S BROOK City of Louisville KY 40202,Vehicle Fire,131,131 - Passenger vehicle fire,0,4000,4000,4000,0
27910,2014,Autumn,10/21/2014,4916 S 3RD n/a City of Louisville KY 40214,Vehicle Fire,131,131 - Passenger vehicle fire,200,10000,10200,10000,-200
28047,2014,Autumn,10/23/2014,432 E JEFFERSON N/A City of Louisville KY 40202,Structure Fire,111,111 - Building fire,500,500,1000,3000000,2999000
28084,2014,Autumn,10/23/2014,3602 GREEN MEADOWS 3 City of Louisville KY 40218,Structure Fire,111,111 - Building fire,20000,80000,100000,400000,300000
28148,2014,Autumn,10/24/2014,2825 KLONDIKE N/A City of Louisville KY 40218,Structure Fire,112,112 - Fires in structure other than in a building,100,200,300,200,-100
28216,2014,Autumn,10/25/2014,I 64 West n/a City of Louisville KY 40206,Vehicle Fire,131,131 - Passenger vehicle fire,200,15000,15200,15000,-200
28420,2014,Autumn,10/27/2014,5216 NEW CUT na City of Louisville KY 40214,Outside Fire,141,"141 - Forest, woods or wildland fire",0,25000,25000,25000,0
28543,2014,Autumn,10/28/2014,1704 MAGAZINE roadway parked City of Louisville KY 40203,Vehicle Fire,131,131 - Passenger vehicle fire,0,2000,2000,2000,0
28553,2014,Autumn,10/28/2014,106 N 40TH na City of Louisville KY 40212,Structure Fire,111,111 - Building fire,500,2000,2500,38800,36300
28624,2014,Autumn,10/29/2014,3701 TAYLOR N/A City of Louisville KY 40215,Outside Fire,151,"151 - Outside rubbish, trash or waste fire",0,50,50,80000,79950
28874,2014,Winter,11/1/2014,818 FETTER n/a City of Louisville KY 40217,Structure Fire,111,111 - Building fire,0,5000,5000,139670,134670
28963,2014,Winter,11/2/2014,3531 COTTER N/A City of Louisville KY 40211,Structure Fire,111,111 - Building fire,400,0,400,0,-400
28970,2014,Winter,11/2/2014,667 CECIL N/A City of Louisville KY 40211,Structure Fire,113,"113 - Cooking fire, confined to container",300,0,300,0,-300
28984,2014,Winter,11/2/2014,939 W WHITNEY n/a City of Louisville KY 40215,Structure Fire,111,111 - Building fire,3500,3500,7000,10000,3000
29073,2014,Winter,11/3/2014,1015 MAGAZINE N/A City of Louisville KY 40203,Structure Fire,111,111 - Building fire,10000,40000,50000,500000,450000
29089,2014,Winter,11/3/2014,1420 THORNBERRY na City of Louisville KY 40215,Structure Fire,112,112 - Fires in structure other than in a building,0,1000,1000,10000,9000
29117,2014,Winter,11/3/2014,3416 PFLANZ N/A City of Louisville KY 40212,Vehicle Fire,131,131 - Passenger vehicle fire,0,2500,2500,2500,0
29121,2014,Winter,11/3/2014,PFLANZ City of Louisville KY 40212,Vehicle Fire,131,131 - Passenger vehicle fire,0,2575,2575,2575,0
29127,2014,Winter,11/3/2014,2211 HALE n/a City of Louisville KY 40210,Structure Fire,111,111 - Building fire,0,200,200,10000,9800
29143,2014,Winter,11/4/2014,3802 PFLANZ N/A City of Louisville KY 40212,Vehicle Fire,131,131 - Passenger vehicle fire,0,3800,3800,3800,0
29197,2014,Winter,11/4/2014,925 S 26TH 3rd Floor Lobby City of Louisville KY 40210,Structure Fire,111,111 - Building fire,0,100,100,1100000,1099900
29258,2014,Winter,11/5/2014,BON AIR City of Kingsley KY 40205,Vehicle Fire,131,131 - Passenger vehicle fire,0,5000,5000,5000,0
29278,2014,Winter,11/5/2014,I 264 West City of Kingsley KY 40205,Vehicle Fire,131,131 - Passenger vehicle fire,50,1000,1050,1000,-50
29283,2014,Winter,11/5/2014,2530 FRANKFORT n/a City of Louisville KY 40206,Vehicle Fire,131,131 - Passenger vehicle fire,0,2000,2000,3000,1000
29388,2014,Winter,11/6/2014,1653 HALE 0 City of Louisville KY 40210,Structure Fire,111,111 - Building fire,0,100,100,100,0
29389,2014,Winter,11/6/2014,4005 W MARKET 103 City of Louisville KY 40212,Structure Fire,111,111 - Building fire,500,1000,1500,74040,72540
29423,2014,Winter,11/7/2014,S 26TH City of Louisville KY 40211,Structure Fire,114,"114 - Chimney or flue fire, confined to chimney or flue",0,100,100,100,0
29435,2014,Winter,11/7/2014,2924 RIO RITA n/a City of Cambridge KY 40220,Structure Fire,111,111 - Building fire,10000,5000,15000,5000,-10000
29474,2014,Winter,11/7/2014,2623 GREENWOOD n/a City of Louisville KY 40211,Structure Fire,111,111 - Building fire,250,0,250,0,-250
29604,2014,Winter,11/9/2014,2641 GRAND na City of Louisville KY 40211,Structure Fire,111,111 - Building fire,0,10000,10000,10000,0
29607,2014,Winter,11/9/2014,1412 S HANCOCK N/A City of Louisville KY 40217,Vehicle Fire,131,131 - Passenger vehicle fire,0,4000,4000,4000,0
29616,2014,Winter,11/9/2014,2319 GREENWOOD na City of Louisville KY 40210,Structure Fire,111,111 - Building fire,0,6000,6000,6000,0
29658,2014,Winter,11/9/2014,1213 RAMMERS n/a City of Louisville KY 40204,Vehicle Fire,131,131 - Passenger vehicle fire,0,3000,3000,3000,0
29616,2014,Winter,11/9/2014,2319 GREENWOOD na City of Louisville KY 40210,Structure Fire,111,111 - Building fire,0,2000,2000,2000,0
29658,2014,Winter,11/9/2014,1213 RAMMERS n/a City of Louisville KY 40204,Structure Fire,111,111 - Building fire,0,250,250,250,0
29658,2014,Winter,11/9/2014,1213 RAMMERS n/a City of Louisville KY 40204,Structure Fire,111,111 - Building fire,0,2500,2500,87000,84500
29748,2014,Winter,11/10/2014,3620 SOUTHERN n/a City of Louisville KY 40211,Vehicle Fire,131,131 - Passenger vehicle fire,0,1000,1000,2000,1000
29807,2014,Winter,11/11/2014,3044 W BROADWAY N/A City of Louisville KY 40211,Vehicle Fire,131,131 - Passenger vehicle fire,0,10000,10000,13000,3000
29928,2014,Winter,11/13/2014,SOUTHERN City of Louisville KY 40214,Vehicle Fire,131,131 - Passenger vehicle fire,500,2000,2500,2000,-500
30042,2014,Winter,11/14/2014,1412 THORNBERRY n/a City of Louisville KY 40215,Structure Fire,111,111 - Building fire,800,200,1000,130000,129000
30061,2014,Winter,11/14/2014,DRESDEN City of Louisville KY 40215,Vehicle Fire,131,131 - Passenger vehicle fire,500,4000,4500,4000,-500
30076,2014,Winter,11/14/2014,4301 PRESTON NA City of Audubon Park KY 40213,Vehicle Fire,131,131 - Passenger vehicle fire,0,1000,1000,6500,5500
30131,2014,Winter,11/15/2014,406 S 10TH laundry room City of Louisville KY 40203,Structure Fire,111,111 - Building fire,3000,2000,5000,500000,495000
30169,2014,Winter,11/15/2014,1413 LYNNHURST na City of Louisville KY 40215,Structure Fire,111,111 - Building fire,4000,80000,84000,80000,-4000
30195,2014,Winter,11/16/2014,724 CALDWELL None City of Louisville KY 40203,Structure Fire,113,"113 - Cooking fire, confined to container",500,0,500,NULL,NULL
30228,2014,Winter,11/16/2014,4425 GREENWOOD n/a City of Louisville KY 40211,Outside Fire,161,161 - Outside storage fire,0,1000,1000,5000,4000
30347,2014,Winter,11/17/2014,407 REG SMITH 303 City of Louisville KY 40208,Structure Fire,113,"113 - Cooking fire, confined to container",1500,0,1500,0,-1500
30432,2014,Winter,11/18/2014,I 264 East City of Kingsley KY 40205,Vehicle Fire,131,131 - Passenger vehicle fire,100,2500,2600,2500,-100
30461,2014,Winter,11/19/2014,1502 LARCHMONT n/a City of Louisville KY 40215,Structure Fire,111,111 - Building fire,2000,5000,7000,71000,64000
30546,2014,Winter,11/20/2014,727 E ORMSBY n/a City of Louisville KY 40203,Structure Fire,116,"116 - Fuel burner/boiler malfunction, fire confined",4000,500,4500,43000,38500
30584,2014,Winter,11/20/2014,5719 MORRISON na City of Louisville KY 40214,Structure Fire,111,111 - Building fire,10000,50000,60000,120000,60000
30617,2014,Winter,11/21/2014,2510 ST CECILIA n/a City of Louisville KY 40212,Vehicle Fire,131,131 - Passenger vehicle fire,0,5000,5000,5000,0
30717,2014,Winter,11/22/2014,960 S 4TH 713 City of Louisville KY 40203,Structure Fire,111,111 - Building fire,1500,50000,51500,538000,486500
30760,2014,Winter,11/22/2014,104 S 40TH N/A City of Louisville KY 40212,Vehicle Fire,131,131 - Passenger vehicle fire,0,200,200,2500,2300
30807,2014,Winter,11/23/2014,530 AMY n/a City of Louisville KY 40211,Vehicle Fire,131,131 - Passenger vehicle fire,0,10000,10000,10000,0
30814,2014,Winter,11/23/2014,667 S 40TH N/A City of Louisville KY 40211,Vehicle Fire,131,131 - Passenger vehicle fire,0,1000,1000,3000,2000
30815,2014,Winter,11/23/2014,2826 W MADISON na City of Louisville KY 40211,Structure Fire,113,"113 - Cooking fire, confined to container",200,200,400,26800,26400
30900,2014,Winter,11/24/2014,1432 S BROOK n/a City of Louisville KY 40208,Structure Fire,111,111 - Building fire,50000,70500,120500,70500,-50000
30900,2014,Winter,11/24/2014,1432 S BROOK n/a City of Louisville KY 40208,Structure Fire,111,111 - Building fire,25000,45000,70000,94000,24000
31009,2014,Winter,11/25/2014,1517 HEMLOCK N/A City of Louisville KY 40211,Structure Fire,111,111 - Building fire,15000,29140,44140,29140,-15000
31015,2014,Winter,11/25/2014,1729 W BROADWAY None City of Louisville KY 40203,Structure Fire,111,111 - Building fire,10000,50000,60000,82600,22600
31113,2014,Winter,11/26/2014,655 COUNTRY CLUB 6 City of Louisville KY 40206,Vehicle Fire,131,131 - Passenger vehicle fire,0,13000,13000,13000,0
31146,2014,Winter,11/26/2014,4231 NORTHWESTERN N/A City of Louisville KY 40212,Structure Fire,111,111 - Building fire,2500,10000,12500,49000,36500
31172,2014,Winter,11/26/2014,1215 S PRESTON n/a City of Louisville KY 40203,Structure Fire,111,111 - Building fire,0,5000,5000,70000,65000
31205,2014,Winter,11/27/2014,I 264 West City of Cambridge KY 40220,Vehicle Fire,132,132 - Road freight or transport vehicle fire,750000,225000,975000,225000,-750000
31234,2014,Winter,11/27/2014,7510 MANSLICK n/a City of Louisville KY 40214,Structure Fire,111,111 - Building fire,500,1500,2000,140000,138000
31255,2014,Winter,11/27/2014,1930 STRATHMOOR n/a City of Kingsley KY 40205,Structure Fire,111,111 - Building fire,0,2500,2500,250000,247500
31295,2014,Winter,11/28/2014,3541 RIVER PARK N/A City of Louisville KY 40211,Structure Fire,111,111 - Building fire,0,2000,2000,30120,28120
31353,2014,Winter,11/29/2014,3705 MANSLICK na City of Louisville KY 40215,Structure Fire,111,111 - Building fire,400,1000,1400,40000,38600
31580,2014,Winter,12/1/2014,1436 S SHELBY N/A City of Louisville KY 40217,Structure Fire,112,112 - Fires in structure other than in a building,200,0,200,0,-200
31615,2014,Winter,12/1/2014,2622 ALFORD N/A City of Louisville KY 40212,Structure Fire,111,111 - Building fire,5000,10000,15000,29400,14400
31619,2014,Winter,12/2/2014,657 S 24TH n/a City of Louisville KY 40211,Structure Fire,111,111 - Building fire,0,500,500,25000,24500
31627,2014,Winter,12/2/2014,331 E ST CATHERINE N/A City of Louisville KY 40203,Structure Fire,111,111 - Building fire,0,1000,1000,105000,104000
31819,2014,Winter,12/4/2014,S 36TH City of Louisville KY 40211,Vehicle Fire,131,131 - Passenger vehicle fire,250,1300,1550,1300,-250
31835,2014,Winter,12/4/2014,W BROADWAY City of Louisville KY 40203,Vehicle Fire,131,131 - Passenger vehicle fire,0,500,500,2000,1500
31911,2014,Winter,12/5/2014,807 MCKINLEY n/a City of Louisville KY 40217,Vehicle Fire,131,131 - Passenger vehicle fire,200,1500,1700,1500,-200
32051,2014,Winter,12/6/2014,1811 CROP na City of Louisville KY 40203,Structure Fire,111,111 - Building fire,0,2000,2000,40500,38500
32092,2014,Winter,12/7/2014,1833 DATE N/A City of Louisville KY 40210,Vehicle Fire,131,131 - Passenger vehicle fire,0,400,400,2500,2100
32195,2014,Winter,12/8/2014,4029 BEECH n/a City of Louisville KY 40215,Structure Fire,111,111 - Building fire,50000,25000,75000,25000,-50000
32241,2014,Winter,12/9/2014,CHURCHMAN City of Louisville KY 40215,Vehicle Fire,131,131 - Passenger vehicle fire,100,5000,5100,5000,-100
32309,2014,Winter,12/10/2014,2333 DUNCAN N/A City of Louisville KY 40212,Structure Fire,111,111 - Building fire,100,1000,1100,32380,31280
32356,2014,Winter,12/10/2014,2704 GRAND 5 City of Louisville KY 40211,Structure Fire,112,112 - Fires in structure other than in a building,2000,2000,4000,2000,-2000
32365,2014,Winter,12/10/2014,I 264 East N/A City of Audubon Park KY 40213,Vehicle Fire,132,132 - Road freight or transport vehicle fire,1000,20000,21000,20000,-1000
32544,2014,Winter,12/12/2014,3019 BUNKER HILL n/a City of Kingsley KY 40205,Structure Fire,111,111 - Building fire,0,500,500,250000,249500
32656,2014,Winter,12/13/2014,3621 DEL PARK NA City of Louisville KY 40211,Structure Fire,111,111 - Building fire,10000,20000,30000,23350,-6650
32670,2014,Winter,12/14/2014,5334 BUCKNER n/a City of Louisville KY 40214,Structure Fire,111,111 - Building fire,3000,5000,8000,85000,77000
32690,2014,Winter,12/14/2014,921 CECIL N/A City of Louisville KY 40211,Outside Fire,154,154 - Dumpster or other outside trash receptacle fire,0,500,500,40000,39500
32713,2014,Winter,12/14/2014,1151 S 32ND N/A City of Louisville KY 40211,Outside Fire,151,"151 - Outside rubbish, trash or waste fire",0,500,500,50000,49500
32742,2014,Winter,12/15/2014,4020 GREENWOOD na City of Louisville KY 40211,Vehicle Fire,131,131 - Passenger vehicle fire,0,3000,3000,3000,0
32941,2014,Winter,12/17/2014,718 S 38TH N/A City of Louisville KY 40211,Structure Fire,111,111 - Building fire,2500,15000,17500,61720,44220
32962,2014,Winter,12/17/2014,1534 SOUTHGATE n/a City of Louisville KY 40215,Structure Fire,111,111 - Building fire,3000,3000,6000,85000,79000
32981,2014,Winter,12/18/2014,1528 S 31ST N/A City of Louisville KY 40211,Vehicle Fire,131,131 - Passenger vehicle fire,0,8000,8000,8000,0
33137,2014,Winter,12/19/2014,3611 KINGS N/A City of Cambridge KY 40220,Structure Fire,111,111 - Building fire,0,3000,3000,97270,94270
33140,2014,Winter,12/19/2014,2715 FERN VALLEY 8 City of Audubon Park KY 40213,Structure Fire,111,111 - Building fire,1000,5000,6000,200000,194000
33187,2014,Winter,12/20/2014,101 CENTRAL 204 City of Louisville KY 40209,Structure Fire,111,111 - Building fire,1000,0,1000,0,-1000
33247,2014,Winter,12/21/2014,805 MARY N/A City of Louisville KY 40204,Outside Fire,140,"140 - Natural vegetation fire, other",0,1000,1000,300000,299000
33343,2014,Winter,12/22/2014,926 E MADISON street side City of Louisville KY 40204,Vehicle Fire,131,131 - Passenger vehicle fire,0,700,700,700,0
33392,2014,Winter,12/22/2014,116 W COLLINS na City of Louisville KY 40214,Structure Fire,111,111 - Building fire,15000,25000,40000,65000,25000
33425,2014,Winter,12/22/2014,1346 SALE n/a City of Louisville KY 40215,Outside Fire,151,"151 - Outside rubbish, trash or waste fire",0,500,500,2000,1500
33529,2014,Winter,12/23/2014,2148 SHERWOOD N/A City of Kingsley KY 40205,Structure Fire,111,111 - Building fire,10000,12000,22000,250000,228000
33612,2014,Winter,12/24/2014,3931 S 3RD 0 City of Louisville KY 40214,Vehicle Fire,131,131 - Passenger vehicle fire,0,1000,1000,2000,1000
33656,2014,Winter,12/25/2014,207 W BROADWAY n/a City of Louisville KY 40202,Vehicle Fire,131,131 - Passenger vehicle fire,0,3635,3635,3635,0
33668,2014,Winter,12/25/2014,1545 DUMESNIL N/A City of Louisville KY 40210,Structure Fire,111,111 - Building fire,5000,20000,25000,24000,-1000
33668,2014,Winter,12/25/2014,1549 DUMESNIL N/A City of Louisville KY 40210,Structure Fire,111,111 - Building fire,0,3500,3500,20000,16500
33709,2014,Winter,12/25/2014,5037 WABASH N/A City of Louisville KY 40214,Structure Fire,111,111 - Building fire,0,35000,35000,93000,58000
33712,2014,Winter,12/25/2014,1022 S JACKSON # 9 City of Louisville KY 40203,Structure Fire,118,"118 - Trash or rubbish fire, contained",200,200,400,200,-200
33743,2014,Winter,12/26/2014,2031 S 41ST NA City of Louisville KY 40211,Structure Fire,111,111 - Building fire,1000,3000,4000,21480,17480
33755,2014,Winter,12/26/2014,I 71 City of Louisville KY 40206,Vehicle Fire,131,131 - Passenger vehicle fire,0,1000,1000,1000,0
34028,2014,Winter,12/29/2014,2501 RIVER BEND D5 City of Louisville KY 40206,Structure Fire,113,"113 - Cooking fire, confined to container",0,1000,1000,500000,499000
34058,2014,Winter,12/30/2014,3671 LENTZ n/ City of Louisville KY 40215,Vehicle Fire,131,131 - Passenger vehicle fire,0,4000,4000,4000,0
34128,2014,Winter,12/30/2014,409 E MUHAMMAD ALI 301 City of Louisville KY 40202,Structure Fire,113,"113 - Cooking fire, confined to container",50,500,550,5000,4450
34153,2014,Winter,12/31/2014,310 E KENTUCKY n/a City of Louisville KY 40203,Structure Fire,111,111 - Building fire,10000,20000,30000,60000,30000
34170,2014,Winter,12/31/2014,1635 PLYMOUTH 12 City of Louisville KY 40203,Structure Fire,111,111 - Building fire,500,1000,1500,353900,352400
34199,2014,Winter,12/31/2014,4700 S 3RD N/A City of Louisville KY 40214,Structure Fire,112,112 - Fires in structure other than in a building,800,0,800,0,-800
56,2015,Winter,1/1/2015,109 S 45TH N/A City of Louisville KY 40212,Structure Fire,111,111 - Building fire,1000,5000,6000,28850,22850
68,2015,Winter,1/1/2015,2115 W KENTUCKY n/a City of Louisville KY 40210,Structure Fire,112,112 - Fires in structure other than in a building,1000,0,1000,0,-1000
77,2015,Winter,1/1/2015,508 E JEFFERSON n/a City of Louisville KY 40202,Vehicle Fire,131,131 - Passenger vehicle fire,0,5000,5000,5000,0
92,2015,Winter,1/1/2015,3814 BANK na City of Louisville KY 40212,Structure Fire,113,"113 - Cooking fire, confined to container",500,0,500,NULL,NULL
207,2015,Winter,1/3/2015,1252 S PRESTON None City of Louisville KY 40203,Structure Fire,111,111 - Building fire,1000,25000,26000,29140,3140
304,2015,Winter,1/4/2015,2338 LEXINGTON n/a City of Louisville KY 40206,Vehicle Fire,131,131 - Passenger vehicle fire,0,2000,2000,2000,0
354,2015,Winter,1/5/2015,167 POPE N/A City of Louisville KY 40206,Structure Fire,111,111 - Building fire,1000,5000,6000,125000,119000
436,2015,Winter,1/5/2015,432 E JEFFERSON basement City of Louisville KY 40202,Structure Fire,118,"118 - Trash or rubbish fire, contained",1000,0,1000,0,-1000
452,2015,Winter,1/6/2015,3645 NICHOLS MEADOW na City of Louisville KY 40215,Vehicle Fire,131,131 - Passenger vehicle fire,500,3000,3500,3000,-500
460,2015,Winter,1/6/2015,S 2ND City of Louisville KY 40208,Vehicle Fire,131,131 - Passenger vehicle fire,0,2000,2000,2000,0
477,2015,Winter,1/6/2015,S 22ND City of Louisville KY 40210,Vehicle Fire,131,131 - Passenger vehicle fire,100,3000,3100,3000,-100
507,2015,Winter,1/6/2015,2640 WENDELL n/a City of Kingsley KY 40205,Vehicle Fire,131,131 - Passenger vehicle fire,0,10000,10000,10000,0
507,2015,Winter,1/6/2015,2640 WENDELL n/a City of Kingsley KY 40205,Structure Fire,111,111 - Building fire,0,8000,8000,150000,142000
507,2015,Winter,1/6/2015,2638 WENDELL n/a City of Kingsley KY 40205,Structure Fire,111,111 - Building fire,0,3000,3000,150000,147000
529,2015,Winter,1/7/2015,3819 GRAND n/a City of Louisville KY 40211,Structure Fire,111,111 - Building fire,0,300,300,40000,39700
684,2015,Winter,1/8/2015,"757 N HITE 757,759,761,763 City of Louisville KY 40206",Vehicle Fire,131,131 - Passenger vehicle fire,0,6000,6000,6000,0
712,2015,Winter,1/8/2015,2101 W OAK 1 City of Louisville KY 40210,Structure Fire,111,111 - Building fire,0,10000,10000,113750,103750
761,2015,Winter,1/9/2015,540 S 18TH N/A City of Louisville KY 40203,Structure Fire,111,111 - Building fire,5000,30000,35000,30000,-5000
819,2015,Winter,1/10/2015,3004 POPLAR LEVEL 2 City of Louisville KY 40217,Structure Fire,111,111 - Building fire,25000,50000,75000,50000,-25000
954,2015,Winter,1/11/2015,W BROADWAY City of Louisville KY 40211,Outside Fire,151,"151 - Outside rubbish, trash or waste fire",0,100,100,100,0
1080,2015,Winter,1/13/2015,1531 S 31ST NA City of Louisville KY 40211,Vehicle Fire,131,131 - Passenger vehicle fire,0,10000,10000,10000,0
1125,2015,Winter,1/13/2015,W BROADWAY City of Louisville KY 40211,Vehicle Fire,131,131 - Passenger vehicle fire,0,200,200,950,750
1133,2015,Winter,1/13/2015,963 S BROOK 2nd floor City of Louisville KY 40203,Structure Fire,111,111 - Building fire,1000,1000,2000,24000,22000
1195,2015,Winter,1/14/2015,1718 W KENTUCKY NA City of Louisville KY 40210,Structure Fire,111,111 - Building fire,0,22560,22560,22560,0
1253,2015,Winter,1/14/2015,4704 PRESTON n/a City of Audubon Park KY 40213,Vehicle Fire,131,131 - Passenger vehicle fire,0,3000,3000,3500,500
1195,2015,Winter,1/14/2015,1720 W KENTUCKY NA City of Louisville KY 40210,Structure Fire,111,111 - Building fire,0,5000,5000,22270,17270
1302,2015,Winter,1/15/2015,I 264 East City of Louisville KY 40215,Vehicle Fire,131,131 - Passenger vehicle fire,0,10000,10000,10000,0
1343,2015,Winter,1/15/2015,I 65 North None City of Louisville KY 40208,Vehicle Fire,131,131 - Passenger vehicle fire,0,5000,5000,5000,0
1437,2015,Winter,1/16/2015,110 W CHESTNUT 1st floor City of Louisville KY 40202,Structure Fire,111,111 - Building fire,2000,1000,3000,5000000,4997000
1462,2015,Winter,1/16/2015,4816 S 3RD 26 City of Louisville KY 40214,Structure Fire,111,111 - Building fire,12000,40000,52000,222000,170000
1501,2015,Winter,1/17/2015,218 N 37TH N/A City of Louisville KY 40212,Structure Fire,111,111 - Building fire,5000,21460,26460,21460,-5000
1552,2015,Winter,1/17/2015,1810 DIXDALE N/A City of Louisville KY 40210,Vehicle Fire,131,131 - Passenger vehicle fire,0,1500,1500,3000,1500
1501,2015,Winter,1/17/2015,218 N 37TH N/A City of Louisville KY 40212,Structure Fire,111,111 - Building fire,0,1000,1000,21530,20530
1639,2015,Winter,1/18/2015,821 HUMLER N/A City of Louisville KY 40211,Structure Fire,118,"118 - Trash or rubbish fire, contained",0,50,50,32000,31950
1686,2015,Winter,1/19/2015,2900 W MUHAMMAD ALI N/A City of Louisville KY 40212,Structure Fire,111,111 - Building fire,5000,10000,15000,20230,5230
1755,2015,Winter,1/20/2015,S 16TH City of Louisville KY 40203,Vehicle Fire,131,131 - Passenger vehicle fire,0,4000,4000,4000,0
1782,2015,Winter,1/20/2015,E BROADWAY City of Louisville KY 40204,Vehicle Fire,131,131 - Passenger vehicle fire,0,1500,1500,3000,1500
1825,2015,Winter,1/20/2015,409 E MUHAMMAD ALI 602 City of Louisville KY 40202,Structure Fire,113,"113 - Cooking fire, confined to container",500,0,500,0,-500
1918,2015,Winter,1/22/2015,1401 CUNNINGHAM N/A City of Louisville KY 40211,Structure Fire,111,111 - Building fire,0,3000,3000,48000,45000
2003,2015,Winter,1/23/2015,2819 GREENWOOD 1 City of Louisville KY 40211,Structure Fire,113,"113 - Cooking fire, confined to container",200,0,200,NULL,NULL
2090,2015,Winter,1/24/2015,GREENWICH City of Louisville KY 40218,Vehicle Fire,131,131 - Passenger vehicle fire,0,1000,1000,1000,0
2159,2015,Winter,1/25/2015,W JEFFERSON City of Louisville KY 40203,Vehicle Fire,131,131 - Passenger vehicle fire,0,5000,5000,5000,0
2199,2015,Winter,1/26/2015,2005 N FIRST STREET basment City of Louisville KY 40208,Structure Fire,115,"115 - Incinerator overload or malfunction, fire confined",400,0,400,5000000,4999600
2384,2015,Winter,1/28/2015,3345 LEXINGTON 0 City of Louisville KY 40206,Structure Fire,111,111 - Building fire,1000,0,1000,0,-1000
2405,2015,Winter,1/28/2015,4021 GRAND N/A City of Louisville KY 40211,Structure Fire,111,111 - Building fire,1000,2000,3000,35000,32000
2578,2015,Winter,1/30/2015,WATTERSON X-WAY ESMT na City of Louisville KY 40211,Vehicle Fire,131,131 - Passenger vehicle fire,1000,15000,16000,15000,-1000
2872,2015,Spring,2/2/2015,4519 HAZELWOOD 4 City of Louisville KY 40214,Structure Fire,111,111 - Building fire,20000,100000,120000,200000,80000
3018,2015,Spring,2/4/2015,4907 FRIDEN na City of Louisville KY 40214,Structure Fire,111,111 - Building fire,20000,30000,50000,30000,-20000
3031,2015,Spring,2/4/2015,163 POPE N/A City of Louisville KY 40206,Structure Fire,111,111 - Building fire,10000,20000,30000,20000,-10000
3091,2015,Spring,2/5/2015,1420 VALLEY N/A City of Audubon Park KY 40213,Structure Fire,111,111 - Building fire,100,1000,1100,2000,900
3216,2015,Spring,2/7/2015,4303 GREENWOOD n/a City of Louisville KY 40211,Structure Fire,111,111 - Building fire,0,10000,10000,50000,40000
3503,2015,Spring,2/10/2015,18 NICHOLS na City of Louisville KY 40215,Vehicle Fire,131,131 - Passenger vehicle fire,2000,5000,7000,5000,-2000
3507,2015,Spring,2/10/2015,206 GHEENS N/A City of Louisville KY 40214,Structure Fire,118,"118 - Trash or rubbish fire, contained",50,0,50,NULL,NULL
3543,2015,Spring,2/11/2015,105 W BRANDEIS Bldg. #83 City of Louisville KY 40208,Structure Fire,111,111 - Building fire,10000,30000,40000,5000000,4960000
3599,2015,Spring,2/11/2015,837 S 23RD n/a City of Louisville KY 40211,Structure Fire,111,111 - Building fire,0,500,500,21600,21100
3606,2015,Spring,2/11/2015,628 E OAK 1 City of Louisville KY 40203,Structure Fire,111,111 - Building fire,50,1000,1050,88000,86950
3657,2015,Spring,2/12/2015,1500 RIVER SHORE n/a City of Louisville KY 40206,Vehicle Fire,130,"130 - Mobile property (vehicle) fire, other",0,100000,100000,100000,0
3670,2015,Spring,2/12/2015,375 ADAMS N/A City of Louisville KY 40206,Vehicle Fire,131,131 - Passenger vehicle fire,0,500,500,500,0
3698,2015,Spring,2/13/2015,1509 W MARKET na City of Louisville KY 40203,Structure Fire,111,111 - Building fire,0,2000,2000,10000,8000
3700,2015,Spring,2/13/2015,3219 VIRGINIA n/a City of Louisville KY 40211,Structure Fire,111,111 - Building fire,0,1000,1000,1000,0
3735,2015,Spring,2/13/2015,4501 S 6TH 49 City of Louisville KY 40214,Structure Fire,111,111 - Building fire,250,2500,2750,2500,-250
3752,2015,Spring,2/13/2015,N 34TH City of Louisville KY 40212,Vehicle Fire,131,131 - Passenger vehicle fire,0,5000,5000,5000,0
3833,2015,Spring,2/14/2015,409 E MUHAMMAD ALI 507 City of Louisville KY 40202,Structure Fire,113,"113 - Cooking fire, confined to container",500,0,500,0,-500
3900,2015,Spring,2/15/2015,931 W MARKET na City of Louisville KY 40202,Vehicle Fire,131,131 - Passenger vehicle fire,0,2000,2000,2000,0
3908,2015,Spring,2/15/2015,3508 W KENTUCKY N/A City of Louisville KY 40211,Structure Fire,111,111 - Building fire,600,500,1100,30280,29180
3999,2015,Spring,2/16/2015,705 IROQUOIS N/A City of Louisville KY 40214,Vehicle Fire,131,131 - Passenger vehicle fire,0,4000,4000,6000,2000
4047,2015,Spring,2/17/2015,1313 LACONA n/a City of Audubon Park KY 40213,Structure Fire,114,"114 - Chimney or flue fire, confined to chimney or flue",500,2000,2500,2000,-500
4066,2015,Spring,2/17/2015,2321 S 35TH NA City of Louisville KY 40211,Vehicle Fire,131,131 - Passenger vehicle fire,0,2000,2000,2000,0
4093,2015,Spring,2/17/2015,1328 HULL n/a City of Louisville KY 40204,Vehicle Fire,131,131 - Passenger vehicle fire,0,3500,3500,3500,0
4128,2015,Spring,2/17/2015,S 15TH City of Louisville KY 40203,Vehicle Fire,131,131 - Passenger vehicle fire,0,11936,11936,11936,0
4155,2015,Spring,2/18/2015,1016 S JACKSON N\A City of Louisville KY 40203,Structure Fire,111,111 - Building fire,250,250,500,260000,259500
4166,2015,Spring,2/18/2015,317 N 38TH na City of Louisville KY 40212,Vehicle Fire,131,131 - Passenger vehicle fire,500,5000,5500,5000,-500
4219,2015,Spring,2/18/2015,CECIL City of Louisville KY 40211,Vehicle Fire,131,131 - Passenger vehicle fire,0,6000,6000,12000,6000
4273,2015,Spring,2/19/2015,I 264 West City of Kingsley KY 40205,Vehicle Fire,131,131 - Passenger vehicle fire,50,5000,5050,5000,-50
4330,2015,Spring,2/20/2015,3000 SOUTHERN N/A City of Louisville KY 40211,Structure Fire,111,111 - Building fire,1000,5000,6000,28000,22000
4553,2015,Spring,2/21/2015,4101 CHURCHMAN n/a City of Louisville KY 40215,Structure Fire,111,111 - Building fire,500,0,500,0,-500
4568,2015,Spring,2/22/2015,3315 HALE N/A City of Louisville KY 40211,Vehicle Fire,131,131 - Passenger vehicle fire,0,2500,2500,6000,3500
4740,2015,Spring,2/23/2015,1901 PAYNE n/a City of Louisville KY 40206,Structure Fire,111,111 - Building fire,0,2000,2000,1000000,998000
4848,2015,Spring,2/24/2015,2418 W MUHAMMAD ALI N/A City of Louisville KY 40212,Structure Fire,114,"114 - Chimney or flue fire, confined to chimney or flue",0,3000,3000,51500,48500
4877,2015,Spring,2/25/2015,S 38TH City of Louisville KY 40212,Vehicle Fire,131,131 - Passenger vehicle fire,0,4000,4000,4000,0
4896,2015,Spring,2/25/2015,1849 DATE na City of Louisville KY 40210,Structure Fire,111,111 - Building fire,0,3000,3000,25150,22150
5023,2015,Spring,2/26/2015,1795 WILSON n/a City of Louisville KY 40210,Structure Fire,111,111 - Building fire,0,3000,3000,60000,57000
5047,2015,Spring,2/27/2015,2505 BROWNSBORO C2 City of Louisville KY 40206,Structure Fire,113,"113 - Cooking fire, confined to container",0,100,100,150,50
5089,2015,Spring,2/27/2015,526 LOCHER n/a City of Louisville KY 40212,Structure Fire,113,"113 - Cooking fire, confined to container",0,1000,1000,15000,14000
5174,2015,Spring,2/28/2015,7152 SOUTHSIDE 3 City of Louisville KY 40214,Structure Fire,113,"113 - Cooking fire, confined to container",400,0,400,NULL,NULL
5250,2015,Spring,3/1/2015,532 DRESDEN none City of Louisville KY 40215,Structure Fire,111,111 - Building fire,5000,15000,20000,52000,32000
5304,2015,Spring,3/1/2015,200 S 5TH N/A City of Louisville KY 40202,Structure Fire,111,111 - Building fire,300,1000,1300,5000000,4998700
5420,2015,Spring,3/3/2015,1519 S 28TH na City of Louisville KY 40211,Structure Fire,111,111 - Building fire,3000,3000,6000,32840,26840
5538,2015,Spring,3/4/2015,960 S 4TH 1018 City of Louisville KY 40203,Structure Fire,111,111 - Building fire,1000,50000,51000,540000,489000
5564,2015,Spring,3/4/2015,6100 DUTCHMANS N/A City of Kingsley KY 40205,Vehicle Fire,131,131 - Passenger vehicle fire,0,8000,8000,8000,0
5594,2015,Spring,3/5/2015,S 41ST City of Louisville KY 40211,Vehicle Fire,131,131 - Passenger vehicle fire,0,5000,5000,5000,0
5634,2015,Spring,3/5/2015,3231 LARKWOOD 2 City of Louisville KY 40212,Structure Fire,111,111 - Building fire,5000,20000,25000,65000,40000
5655,2015,Spring,3/5/2015,1235 S 3RD n/a City of Louisville KY 40203,Vehicle Fire,131,131 - Passenger vehicle fire,0,3000,3000,3000,0
5690,2015,Spring,3/6/2015,1758 W OAK na City of Louisville KY 40210,Structure Fire,111,111 - Building fire,100,200,300,200,-100
5722,2015,Spring,3/6/2015,1501 RUNDILL N/A City of Louisville KY 40214,Vehicle Fire,131,131 - Passenger vehicle fire,0,2000,2000,2000,0
5753,2015,Spring,3/6/2015,1574 SADIE na City of Louisville KY 40216,Structure Fire,111,111 - Building fire,10000,20000,30000,20000,-10000
5780,2015,Spring,3/6/2015,I 65 North na City of Louisville KY 40202,Vehicle Fire,131,131 - Passenger vehicle fire,0,500,500,2000,1500
5753,2015,Spring,3/6/2015,4405 YOLANDA na City of Louisville KY 40216,Structure Fire,111,111 - Building fire,0,3000,3000,3000,0
5753,2015,Spring,3/6/2015,4405 YOLANDA na City of Louisville KY 40216,Structure Fire,111,111 - Building fire,0,3000,3000,3000,0
5810,2015,Spring,3/7/2015,3108 DALE ANN N/A City of Cambridge KY 40220,Vehicle Fire,131,131 - Passenger vehicle fire,0,1000,1000,1000,0
5893,2015,Spring,3/8/2015,I 264 West City of Audubon Park KY 40213,Vehicle Fire,131,131 - Passenger vehicle fire,200,7000,7200,7000,-200
5914,2015,Spring,3/8/2015,1705 PRENTICE n/a City of Louisville KY 40210,Structure Fire,111,111 - Building fire,500,5000,5500,20000,14500
5932,2015,Spring,3/8/2015,415 E MUHAMMAD ALI 906 City of Louisville KY 40202,Structure Fire,111,111 - Building fire,300,0,300,NULL,NULL
5980,2015,Spring,3/9/2015,1312 S FLOYD 2 City of Louisville KY 40208,Structure Fire,111,111 - Building fire,2000,2000,4000,140000,136000
6029,2015,Spring,3/9/2015,2020 NEWBURG N/A City of Kingsley KY 40205,Structure Fire,118,"118 - Trash or rubbish fire, contained",100,0,100,NULL,NULL
6055,2015,Spring,3/9/2015,112 N 26TH N/A City of Louisville KY 40212,Structure Fire,111,111 - Building fire,1000,3000,4000,22950,18950
6215,2015,Spring,3/11/2015,4133 TAYLOR outside City of Louisville KY 40215,Vehicle Fire,131,131 - Passenger vehicle fire,200,7000,7200,8500,1300
6319,2015,Spring,3/12/2015,2530 SLEVIN 302 City of Louisville KY 40212,Structure Fire,111,111 - Building fire,100,1000,1100,2125590,2124490
6330,2015,Spring,3/12/2015,119 LENOAK N/A City of Louisville KY 40214,Structure Fire,111,111 - Building fire,3000,11000,14000,140000,126000
6408,2015,Spring,3/13/2015,3808 FINCASTLE n/a City of Audubon Park KY 40213,Structure Fire,111,111 - Building fire,100000,200000,300000,419000,119000
6458,2015,Spring,3/14/2015,MCCLOSKEY City of Louisville KY 40210,Vehicle Fire,131,131 - Passenger vehicle fire,0,1000,1000,5000,4000
6483,2015,Spring,3/14/2015,NEWBURG City of Louisville KY 40218,Vehicle Fire,131,131 - Passenger vehicle fire,0,2000,2000,2000,0
6592,2015,Spring,3/15/2015,2851 CLEVELAND na City of Louisville KY 40206,Vehicle Fire,131,131 - Passenger vehicle fire,0,4500,4500,4500,0
6812,2015,Spring,3/17/2015,BICKNELL City of Louisville KY 40215,Vehicle Fire,131,131 - Passenger vehicle fire,0,5000,5000,5000,0
6874,2015,Spring,3/18/2015,2001 TERRIL 7 City of Louisville KY 40218,Structure Fire,113,"113 - Cooking fire, confined to container",500,0,500,0,-500
6883,2015,Spring,3/18/2015,1239 HULL N/A City of Louisville KY 40204,Structure Fire,111,111 - Building fire,10000,57855,67855,90670,22815
6892,2015,Spring,3/18/2015,211 W SOUTHLAND N/A City of Louisville KY 40214,Structure Fire,111,111 - Building fire,15000,30000,45000,80000,35000
6883,2015,Spring,3/18/2015,1239 HULL N/A City of Louisville KY 40204,Structure Fire,111,111 - Building fire,10000,63000,73000,97260,24260
7013,2015,Spring,3/19/2015,HIKES City of Cambridge KY 40220,Vehicle Fire,131,131 - Passenger vehicle fire,0,350,350,3000,2650
7090,2015,Spring,3/20/2015,1018 S 15TH n/a City of Louisville KY 40210,Structure Fire,111,111 - Building fire,100,0,100,0,-100
7114,2015,Spring,3/21/2015,814 S 23RD n/a City of Louisville KY 40211,Structure Fire,111,111 - Building fire,0,10000,10000,30000,20000
7118,2015,Spring,3/21/2015,343 N 26TH n/a City of Louisville KY 40212,Structure Fire,111,111 - Building fire,2000,32300,34300,32300,-2000
7118,2015,Spring,3/21/2015,341 N 26TH n/a City of Louisville KY 40212,Structure Fire,111,111 - Building fire,1000,2000,3000,25000,22000
7118,2015,Spring,3/21/2015,345 N 26TH n/a City of Louisville KY 40212,Structure Fire,111,111 - Building fire,2000,3000,5000,25000,20000
7138,2015,Spring,3/21/2015,3411 ROWENA 3 City of Louisville KY 40218,Structure Fire,111,111 - Building fire,5000,15000,20000,240000,220000
7153,2015,Spring,3/21/2015,S 23RD City of Louisville KY 40212,Structure Fire,111,111 - Building fire,0,1000,1000,20990,19990
7181,2015,Spring,3/21/2015,1134 PLATO N/A City of Louisville KY 40211,Structure Fire,111,111 - Building fire,10000,20000,30000,70750,40750
7225,2015,Spring,3/22/2015,1516 W OAK 2 City of Louisville KY 40210,Structure Fire,111,111 - Building fire,2000,10000,12000,80000,68000
7253,2015,Spring,3/22/2015,1831 GREENWOOD n/a City of Louisville KY 40210,Vehicle Fire,131,131 - Passenger vehicle fire,0,3200,3200,3200,0
7225,2015,Spring,3/22/2015,1518 W OAK 2 City of Louisville KY 40210,Structure Fire,111,111 - Building fire,0,1000,1000,90000,89000
7310,2015,Spring,3/23/2015,2705 W KENTUCKY n/a City of Louisville KY 40211,Structure Fire,111,111 - Building fire,0,25000,25000,55000,30000
7338,2015,Spring,3/23/2015,1904 CEDAR n/a City of Louisville KY 40203,Structure Fire,118,"118 - Trash or rubbish fire, contained",0,5000,5000,67840,62840
7375,2015,Spring,3/23/2015,DIXIE City of Louisville KY 40210,Vehicle Fire,131,131 - Passenger vehicle fire,0,8000,8000,10000,2000
7380,2015,Spring,3/23/2015,1809 ALGONQUIN N/A City of Louisville KY 40210,Structure Fire,111,111 - Building fire,100,1000,1100,85000,83900
7338,2015,Spring,3/23/2015,1904 CEDAR n/a City of Louisville KY 40203,Structure Fire,118,"118 - Trash or rubbish fire, contained",0,5000,5000,67840,62840
7413,2015,Spring,3/24/2015,N 16TH City of Louisville KY 40203,Vehicle Fire,131,131 - Passenger vehicle fire,0,5000,5000,5000,0
7426,2015,Spring,3/24/2015,3201 GOLDEN TURTLE 102 City of Louisville KY 40218,Structure Fire,111,111 - Building fire,2500,5000,7500,260000,252500
7427,2015,Spring,3/24/2015,525 N 19TH 0 City of Louisville KY 40203,Structure Fire,111,111 - Building fire,0,1000,1000,31810,30810
7454,2015,Spring,3/24/2015,I 64 East City of Louisville KY 40203,Vehicle Fire,131,131 - Passenger vehicle fire,0,800,800,8000,7200
7413,2015,Spring,3/24/2015,N 16TH City of Louisville KY 40203,Structure Fire,111,111 - Building fire,0,1000,1000,25000,24000
7499,2015,Spring,3/25/2015,2905 RIEDLING N/A City of Louisville KY 40206,Vehicle Fire,131,131 - Passenger vehicle fire,0,12000,12000,12000,0
7563,2015,Spring,3/25/2015,SUTCLIFFE City of Louisville KY 40211,Vehicle Fire,131,131 - Passenger vehicle fire,0,1000,1000,1000,0
7565,2015,Spring,3/25/2015,4112 BERKSHIRE N/A City of Cambridge KY 40220,Structure Fire,111,111 - Building fire,1000,8000,9000,140000,131000
7629,2015,Spring,3/26/2015,KEMMONS City of Louisville KY 40218,Vehicle Fire,131,131 - Passenger vehicle fire,0,2000,2000,2000,0
7697,2015,Spring,3/27/2015,2915 DUMESNIL N/A City of Louisville KY 40211,Structure Fire,111,111 - Building fire,10000,20000,30000,36000,6000
7791,2015,Spring,3/28/2015,3919 MIAMI N/A City of Louisville KY 40212,Vehicle Fire,131,131 - Passenger vehicle fire,0,7400,7400,7400,0
7809,2015,Spring,3/28/2015,DUTCHMANS City of Kingsley KY 40205,Vehicle Fire,131,131 - Passenger vehicle fire,0,1500,1500,5000,3500
7893,2015,Spring,3/29/2015,640 ZORN 5B City of Louisville KY 40206,Structure Fire,111,111 - Building fire,5000,5000,10000,120000,110000
7905,2015,Spring,3/29/2015,926 E OAK N/A City of Louisville KY 40204,Structure Fire,111,111 - Building fire,1000,8000,9000,100000,91000
7954,2015,Spring,3/30/2015,420 E OAK none City of Louisville KY 40203,Structure Fire,111,111 - Building fire,500,500,1000,500,-500
8024,2015,Spring,3/30/2015,631 MIX n/a City of Louisville KY 40208,Structure Fire,111,111 - Building fire,0,30000,30000,30000,0
8050,2015,Spring,3/31/2015,DUMESNIL City of Louisville KY 40210,Structure Fire,112,112 - Fires in structure other than in a building,0,300,300,1000,700
8099,2015,Spring,3/31/2015,3007 POPLAR LEVEL n/a City of Louisville KY 40217,Structure Fire,111,111 - Building fire,10000,0,10000,0,-10000
8130,2015,Spring,3/31/2015,TAYLOR n/a City of Louisville KY 40215,Vehicle Fire,131,131 - Passenger vehicle fire,0,3000,3000,3000,0
8219,2015,Spring,4/1/2015,2321 W OAK Back Porch City of Louisville KY 40210,Structure Fire,111,111 - Building fire,0,1000,1000,40000,39000
8255,2015,Spring,4/1/2015,S 28TH City of Louisville KY 40211,Vehicle Fire,131,131 - Passenger vehicle fire,300,3000,3300,3000,-300
8318,2015,Spring,4/2/2015,2730 CANNONS n/a City of Kingsley KY 40205,Structure Fire,111,111 - Building fire,0,25000,25000,400000,375000
8614,2015,Spring,4/3/2015,403 S 41ST N/A City of Louisville KY 40212,Structure Fire,111,111 - Building fire,0,1000,1000,47000,46000
8593,2015,Spring,4/3/2015,2014 PEABODY N/A City of Louisville KY 40218,Vehicle Fire,131,131 - Passenger vehicle fire,0,500,500,500,0
8685,2015,Spring,4/4/2015,I 64 West n/a City of Louisville KY 40206,Vehicle Fire,131,131 - Passenger vehicle fire,0,2000,2000,3500,1500
8691,2015,Spring,4/4/2015,526 LOCHER 205 City of Louisville KY 40212,Structure Fire,111,111 - Building fire,500,2000,2500,300000,297500
8699,2015,Spring,4/4/2015,E BURNETT City of Louisville KY 40217,Structure Fire,120,"120 - Fire in mobile prop. used as a fixed struc., other",0,2500,2500,2500,0
8784,2015,Spring,4/5/2015,HIKES City of Louisville KY 40218,Vehicle Fire,131,131 - Passenger vehicle fire,0,800,800,2000,1200
8787,2015,Spring,4/5/2015,I 64 East City of Louisville KY 40212,Vehicle Fire,131,131 - Passenger vehicle fire,0,2188,2188,2188,0
8808,2015,Spring,4/5/2015,2820 FLORA 13 City of Cambridge KY 40220,Structure Fire,111,111 - Building fire,0,50,50,288000,287950
8844,2015,Spring,4/6/2015,923 S 2ND 310 City of Louisville KY 40203,Structure Fire,111,111 - Building fire,500,0,500,0,-500
8888,2015,Spring,4/6/2015,3300 INDIAN CREEK 4 City of Louisville KY 40218,Structure Fire,111,111 - Building fire,500,2500,3000,500000,497000
8915,2015,Spring,4/6/2015,2122 CLEVELAND NA City of Louisville KY 40203,Structure Fire,111,111 - Building fire,0,19830,19830,19830,0
8926,2015,Spring,4/7/2015,1200BLK S PRESTON na City of Louisville KY 40203,Vehicle Fire,131,131 - Passenger vehicle fire,200,2000,2200,2000,-200
8936,2015,Spring,4/7/2015,3427 HALE n/a City of Louisville KY 40211,Structure Fire,111,111 - Building fire,1000,0,1000,0,-1000
8963,2015,Spring,4/7/2015,I 64 West City of Louisville KY 40206,Vehicle Fire,131,131 - Passenger vehicle fire,0,5000,5000,5000,0
9026,2015,Spring,4/8/2015,2005 TERRIL 5 City of Louisville KY 40218,Structure Fire,111,111 - Building fire,0,1000,1000,1000,0
9062,2015,Spring,4/8/2015,18 NICHOLS na City of Louisville KY 40215,Structure Fire,111,111 - Building fire,10000,35000,45000,35000,-10000
9062,2015,Spring,4/8/2015,18 NICHOLS na City of Louisville KY 40215,Structure Fire,111,111 - Building fire,0,500,500,500,0
9062,2015,Spring,4/8/2015,16 NICHOLS na City of Louisville KY 40215,Structure Fire,111,111 - Building fire,0,1000,1000,1000,0
9162,2015,Spring,4/9/2015,240 HALDEMAN N/A City of Louisville KY 40206,Structure Fire,111,111 - Building fire,10000,50000,60000,150000,90000
9258,2015,Spring,4/10/2015,S 32ND City of Louisville KY 40211,Vehicle Fire,131,131 - Passenger vehicle fire,0,3000,3000,3000,0
9270,2015,Spring,4/10/2015,256 S 39TH n/a City of Louisville KY 40212,Structure Fire,111,111 - Building fire,500,100,600,30000,29400
9334,2015,Spring,4/10/2015,3381 LESTER N/A City of Louisville KY 40215,Structure Fire,111,111 - Building fire,10000,30000,40000,30000,-10000
9433,2015,Spring,4/11/2015,1417 S 28TH N/A City of Louisville KY 40211,Structure Fire,111,111 - Building fire,5000,20000,25000,80000,55000
9437,2015,Spring,4/11/2015,2426 ELLIOTT 0 City of Louisville KY 40211,Structure Fire,118,"118 - Trash or rubbish fire, contained",0,500,500,3000,2500
9449,2015,Spring,4/12/2015,I 65 North City of Louisville KY 40202,Vehicle Fire,131,131 - Passenger vehicle fire,600,600,1200,600,-600
9574,2015,Spring,4/13/2015,2314 HALE NA City of Louisville KY 40210,Structure Fire,111,111 - Building fire,0,15000,15000,15000,0
9580,2015,Spring,4/13/2015,2709 GARLAND na City of Louisville KY 40211,Structure Fire,111,111 - Building fire,500,2000,2500,20000,17500
9587,2015,Spring,4/13/2015,138 E AMHERST n/a City of Louisville KY 40214,Structure Fire,111,111 - Building fire,0,1000,1000,76900,75900
9670,2015,Spring,4/14/2015,1738 DIXIE na City of Louisville KY 40210,Structure Fire,111,111 - Building fire,0,1000,1000,52120,51120
9791,2015,Spring,4/16/2015,1921 W MADISON N/A City of Louisville KY 40203,Vehicle Fire,131,131 - Passenger vehicle fire,0,10000,10000,30000,20000
10066,2015,Spring,4/18/2015,S 32ND City of Louisville KY 40211,Vehicle Fire,131,131 - Passenger vehicle fire,100,1000,1100,5000,3900
10151,2015,Spring,4/19/2015,579 QUEST N/A City of Louisville KY 40203,Vehicle Fire,131,131 - Passenger vehicle fire,0,1500,1500,1500,0
10246,2015,Spring,4/20/2015,4410 S 8TH na City of Louisville KY 40215,Structure Fire,111,111 - Building fire,10000,40000,50000,40000,-10000
10270,2015,Spring,4/20/2015,1108 DIXIE entire house City of Louisville KY 40210,Structure Fire,111,111 - Building fire,0,60000,60000,60000,0
10281,2015,Spring,4/20/2015,415 E MUHAMMAD ALI 907 City of Louisville KY 40202,Structure Fire,111,111 - Building fire,500,0,500,0,-500
10320,2015,Spring,4/21/2015,S 15TH City of Louisville KY 40203,Vehicle Fire,131,131 - Passenger vehicle fire,0,500,500,5000,4500
10331,2015,Spring,4/21/2015,415 E MUHAMMAD ALI 907 City of Louisville KY 40202,Structure Fire,111,111 - Building fire,200,500000,500200,6110640,5610440
10343,2015,Spring,4/21/2015,1342 BERRY na City of Louisville KY 40215,Structure Fire,111,111 - Building fire,10000,50000,60000,100000,40000
10346,2015,Spring,4/21/2015,648 S 37TH n/a City of Louisville KY 40211,Structure Fire,118,"118 - Trash or rubbish fire, contained",100,2000,2100,5000,2900
10406,2015,Spring,4/21/2015,3506 MAYO n/a City of Louisville KY 40218,Structure Fire,111,111 - Building fire,150,0,150,NULL,NULL
10343,2015,Spring,4/21/2015,1342 BERRY na City of Louisville KY 40215,Structure Fire,111,111 - Building fire,0,1500,1500,41000,39500
10485,2015,Spring,4/22/2015,226 SHAWNEE NA City of Louisville KY 40212,Structure Fire,111,111 - Building fire,10000,32000,42000,32000,-10000
10540,2015,Spring,4/23/2015,219 E ORMSBY 18 City of Louisville KY 40203,Structure Fire,111,111 - Building fire,0,15000,15000,15000,0
10566,2015,Spring,4/23/2015,2321 DUNCAN N/A City of Louisville KY 40212,Vehicle Fire,131,131 - Passenger vehicle fire,0,2175,2175,2175,0
10570,2015,Spring,4/23/2015,3711 LEXINGTON n/a City of Beechwood Village KY 40207,Outside Fire,142,142 - Brush or brush-and-grass mixture fire,0,300,300,1055790,1055490
10672,2015,Spring,4/24/2015,S 19TH City of Louisville KY 40203,Vehicle Fire,131,131 - Passenger vehicle fire,0,1500,1500,1500,0
10688,2015,Spring,4/24/2015,611 BELLAMY 304 City of Louisville KY 40208,Structure Fire,113,"113 - Cooking fire, confined to container",1000,3000,4000,3000000,2996000
10613,2015,Spring,4/24/2015,601 WIMBLETON n/a City of Louisville KY 40218,Vehicle Fire,131,131 - Passenger vehicle fire,0,42000,42000,50000,8000
10613,2015,Spring,4/24/2015,601 WIMBLETON n/a City of Louisville KY 40218,Vehicle Fire,131,131 - Passenger vehicle fire,0,42000,42000,50000,8000
10710,2015,Spring,4/25/2015,1520 HEPBURN B City of Louisville KY 40204,Structure Fire,118,"118 - Trash or rubbish fire, contained",0,1500,1500,1500,0
10717,2015,Spring,4/25/2015,1022 S 29TH 8 City of Louisville KY 40211,Structure Fire,111,111 - Building fire,5000,10000,15000,250000,235000
10778,2015,Spring,4/25/2015,I 264 East City of Louisville KY 40218,Vehicle Fire,131,131 - Passenger vehicle fire,0,2000,2000,2000,0
10817,2015,Spring,4/26/2015,401 W CARDINAL 144 City of Louisville KY 40208,Structure Fire,111,111 - Building fire,200,1000,1200,1000000,998800
10866,2015,Spring,4/27/2015,436 E KENTUCKY 102 City of Louisville KY 40203,Structure Fire,112,112 - Fires in structure other than in a building,1000,1000,2000,45000,43000
10887,2015,Spring,4/27/2015,4811 S 3RD B City of Louisville KY 40214,Structure Fire,111,111 - Building fire,2000,5000,7000,1649010,1642010
10953,2015,Spring,4/28/2015,2222 GARFIELD N/A City of Louisville KY 40212,Structure Fire,111,111 - Building fire,1000,10000,11000,16000,5000
10971,2015,Spring,4/28/2015,S 43RD City of Louisville KY 40212,Vehicle Fire,131,131 - Passenger vehicle fire,0,1000,1000,1400,400
11006,2015,Spring,4/28/2015,1348 S 26TH N/A City of Louisville KY 40210,Structure Fire,111,111 - Building fire,0,31420,31420,31420,0
11006,2015,Spring,4/28/2015,1350 S 26TH N/A City of Louisville KY 40210,Structure Fire,111,111 - Building fire,0,2000,2000,29450,27450
11218,2015,Spring,4/30/2015,2715 WYANDOTTE NA City of Louisville KY 40210,Structure Fire,111,111 - Building fire,3000,5000,8000,27870,19870
11247,2015,Summer,5/1/2015,2410 DUMESNIL N/A City of Louisville KY 40210,Structure Fire,111,111 - Building fire,10000,15000,25000,34610,9610
11291,2015,Summer,5/1/2015,2217 DUMESNIL N/A City of Louisville KY 40210,Structure Fire,111,111 - Building fire,10000,15000,25000,22900,-2100
11399,2015,Summer,5/2/2015,I 264 West N/A City of Louisville KY 40209,Vehicle Fire,131,131 - Passenger vehicle fire,0,1000,1000,12000,11000
11521,2015,Summer,5/3/2015,1422 CATALPA N/A City of Louisville KY 40211,Structure Fire,111,111 - Building fire,300,2000,2300,20930,18630
11731,2015,Summer,5/5/2015,1357 S 2ND 3 City of Louisville KY 40208,Structure Fire,113,"113 - Cooking fire, confined to container",0,1000,1000,150000,149000
11883,2015,Summer,5/6/2015,DIXIE City of Louisville KY 40210,Vehicle Fire,131,131 - Passenger vehicle fire,0,1000,1000,2500,1500
11913,2015,Summer,5/7/2015,1703 CYPRESS n/a City of Louisville KY 40210,Structure Fire,111,111 - Building fire,6000,10000,16000,100000,84000
11921,2015,Summer,5/7/2015,3025 JUNIPER HILL None City of Louisville KY 40206,Structure Fire,111,111 - Building fire,2000,20000,22000,432090,410090
11934,2015,Summer,5/7/2015,4325 VERMONT 211 City of Louisville KY 40211,Structure Fire,113,"113 - Cooking fire, confined to container",200,0,200,NULL,NULL
11913,2015,Summer,5/7/2015,1701 CYPRESS n/a City of Louisville KY 40210,Structure Fire,111,111 - Building fire,0,2000,2000,120000,118000
11921,2015,Summer,5/7/2015,3025 JUNIPER HILL None City of Louisville KY 40206,Structure Fire,111,111 - Building fire,0,2000,2000,35000,33000
11942,2015,Summer,5/7/2015,2610 W MARKET na City of Louisville KY 40212,Vehicle Fire,131,131 - Passenger vehicle fire,0,1000,1000,1000,0
11984,2015,Summer,5/7/2015,48 WARREN N/A City of Louisville KY 40206,Structure Fire,111,111 - Building fire,10000,75000,85000,175000,90000
12199,2015,Summer,5/9/2015,222 GHEENS n/a City of Louisville KY 40214,Structure Fire,111,111 - Building fire,15000,30000,45000,126350,81350
12279,2015,Summer,5/10/2015,4130 RIVER PARK N/A City of Louisville KY 40211,Structure Fire,113,"113 - Cooking fire, confined to container",500,0,500,55550,55050
12337,2015,Summer,5/10/2015,3666 CRAIG n/a City of Louisville KY 40215,Structure Fire,111,111 - Building fire,0,500,500,50780,50280
12421,2015,Summer,5/11/2015,615 IOWA n/a City of Louisville KY 40208,Structure Fire,111,111 - Building fire,1500,10000,11500,60000,48500
12421,2015,Summer,5/11/2015,613 IOWA n/a City of Louisville KY 40208,Structure Fire,111,111 - Building fire,0,1000,1000,60000,59000
12580,2015,Summer,5/13/2015,3318 GREENWOOD na City of Louisville KY 40211,Structure Fire,113,"113 - Cooking fire, confined to container",500,0,500,NULL,NULL
12607,2015,Summer,5/13/2015,909 S 32ND kitchen City of Louisville KY 40211,Structure Fire,111,111 - Building fire,500,500,1000,50000,49000
12629,2015,Summer,5/13/2015,S PRESTON City of Louisville KY 40203,Vehicle Fire,131,131 - Passenger vehicle fire,0,10000,10000,10000,0
12761,2015,Summer,5/15/2015,2342 EMERSON n/a City of Kingsley KY 40205,Vehicle Fire,131,131 - Passenger vehicle fire,200,3000,3200,3000,-200
12791,2015,Summer,5/15/2015,3643 DENA 1 City of Louisville KY 40215,Structure Fire,111,111 - Building fire,1000,1000,2000,160000,158000
12811,2015,Summer,5/15/2015,2123 S PRESTON none City of Louisville KY 40217,Structure Fire,111,111 - Building fire,50,0,50,NULL,NULL
12880,2015,Summer,5/16/2015,2348 EMERSON N/A City of Kingsley KY 40205,Vehicle Fire,131,131 - Passenger vehicle fire,0,5500,5500,5500,0
13016,2015,Summer,5/17/2015,2202 W OAK na City of Louisville KY 40210,Structure Fire,111,111 - Building fire,7000,10000,17000,39650,22650
13023,2015,Summer,5/17/2015,1200 MAPLE na City of Louisville KY 40210,Structure Fire,111,111 - Building fire,3000,0,3000,1000000,997000
13067,2015,Summer,5/17/2015,2018 PEABODY 11 City of Louisville KY 40218,Structure Fire,111,111 - Building fire,200,200,400,110000,109600
13188,2015,Summer,5/19/2015,2622 PORTLAND n/a City of Louisville KY 40212,Structure Fire,111,111 - Building fire,0,1000,1000,20000,19000
13269,2015,Summer,5/19/2015,2309 W CHESTNUT N/A City of Louisville KY 40211,Structure Fire,111,111 - Building fire,5000,45640,50640,45640,-5000
13269,2015,Summer,5/19/2015,2309 W CHESTNUT N/A City of Louisville KY 40211,Structure Fire,111,111 - Building fire,5000,10000,15000,47640,32640
13382,2015,Summer,5/21/2015,2209 EDDY N/A City of Louisville KY 40212,Outside Fire,151,"151 - Outside rubbish, trash or waste fire",0,200,200,200,0
13487,2015,Summer,5/22/2015,314 N 25TH n/a City of Louisville KY 40212,Structure Fire,111,111 - Building fire,0,2000,2000,22000,20000
13551,2015,Summer,5/22/2015,1630 ARTHUR n/a City of Louisville KY 40208,Vehicle Fire,137,137 - Camper or recreational vehicle (RV) fire,5000,20000,25000,60000,35000
13567,2015,Summer,5/22/2015,3165 S 2ND n/a City of Louisville KY 40208,Vehicle Fire,131,131 - Passenger vehicle fire,350,5000,5350,5000,-350
13572,2015,Summer,5/22/2015,2322 LYTLE n/a City of Louisville KY 40212,Structure Fire,111,111 - Building fire,0,2500,2500,25800,23300
13574,2015,Summer,5/22/2015,3606 GARLAND na City of Louisville KY 40211,Structure Fire,113,"113 - Cooking fire, confined to container",1000,3000,4000,37000,33000
13551,2015,Summer,5/22/2015,1630 ARTHUR n/a City of Louisville KY 40208,Vehicle Fire,137,137 - Camper or recreational vehicle (RV) fire,0,2500,2500,4000,1500
13678,2015,Summer,5/23/2015,723 S 24TH na City of Louisville KY 40211,Structure Fire,111,111 - Building fire,0,3680,3680,3680,0
13752,2015,Summer,5/24/2015,2610 GRAND N/A City of Louisville KY 40211,Structure Fire,111,111 - Building fire,8000,10000,18000,15000,-3000
13785,2015,Summer,5/24/2015,S 11TH City of Louisville KY 40203,Vehicle Fire,131,131 - Passenger vehicle fire,0,500,500,1000,500
13752,2015,Summer,5/24/2015,2612 GRAND N/A City of Louisville KY 40211,Structure Fire,111,111 - Building fire,0,15000,15000,22500,7500
13752,2015,Summer,5/24/2015,1100 S 26th N/A City of Louisville KY 40211,Structure Fire,111,111 - Building fire,5000,1000,6000,35650,29650
13864,2015,Summer,5/25/2015,1457 BLUEGRASS 0 City of Louisville KY 40215,Structure Fire,111,111 - Building fire,500,500,1000,500,-500
13891,2015,Summer,5/25/2015,4115 GRAND N/A City of Louisville KY 40211,Outside Fire,143,143 - Grass fire,0,50,50,50,0
14251,2015,Summer,5/29/2015,2216 STANDARD na City of Louisville KY 40210,Structure Fire,111,111 - Building fire,0,100,100,29500,29400
14390,2015,Summer,5/30/2015,600BLK E BURNETT n/a City of Louisville KY 40217,Vehicle Fire,131,131 - Passenger vehicle fire,0,3000,3000,3000,0
14700,2015,Summer,6/3/2015,447 WILBERFORCE N/A City of Louisville KY 40203,Vehicle Fire,131,131 - Passenger vehicle fire,0,2500,2500,2500,0
14828,2015,Summer,6/4/2015,1941 S 30TH na City of Louisville KY 40210,Structure Fire,111,111 - Building fire,0,24500,24500,24500,0
14828,2015,Summer,6/4/2015,1939 S 30TH na City of Louisville KY 40210,Structure Fire,111,111 - Building fire,0,500,500,18690,18190
15057,2015,Summer,6/6/2015,1326 BARRET 6 City of Louisville KY 40204,Structure Fire,111,111 - Building fire,500,5000,5500,450000,444500
15144,2015,Summer,6/7/2015,110 OXMOOR n/a City of Bancroft KY 40222,Outside Fire,142,142 - Brush or brush-and-grass mixture fire,0,15,15,100,85
15168,2015,Summer,6/7/2015,112 ST FRANCIS N/A City of Kingsley KY 40205,Structure Fire,111,111 - Building fire,0,5000,5000,600000,595000
15195,2015,Summer,6/8/2015,947 BAXTER 102 City of Louisville KY 40204,Structure Fire,111,111 - Building fire,0,1000,1000,1000,0
15285,2015,Summer,6/9/2015,2415 LYTLE NA City of Louisville KY 40212,Vehicle Fire,131,131 - Passenger vehicle fire,0,2500,2500,2500,0
15335,2015,Summer,6/9/2015,513 S 24TH na City of Louisville KY 40211,Structure Fire,111,111 - Building fire,5000,7000,12000,13520,1520
15476,2015,Summer,6/10/2015,4305 W MUHAMMAD ALI na City of Louisville KY 40212,Structure Fire,111,111 - Building fire,0,100,100,1000,900
15555,2015,Summer,6/11/2015,6527 ESTELE n/a City of Louisville KY 40214,Structure Fire,111,111 - Building fire,0,10000,10000,60000,50000
15598,2015,Summer,6/11/2015,1314 S 26TH NA City of Louisville KY 40210,Structure Fire,111,111 - Building fire,1000,21430,22430,21430,-1000
15646,2015,Summer,6/12/2015,1528 W ST CATHERINE kitchen City of Louisville KY 40210,Structure Fire,111,111 - Building fire,300,200,500,25000,24500
15809,2015,Summer,6/13/2015,415 E MUHAMMAD ALI 1602 City of Louisville KY 40202,Structure Fire,113,"113 - Cooking fire, confined to container",2000,2000,4000,10000,6000
15876,2015,Summer,6/14/2015,1600 GARDINER 114 City of Kingsley KY 40205,Structure Fire,111,111 - Building fire,2500,5000,7500,5000,-2500
15902,2015,Summer,6/14/2015,402 S CLAY na City of Louisville KY 40202,Structure Fire,113,"113 - Cooking fire, confined to container",3000,400,3400,39910,36510
15904,2015,Summer,6/14/2015,1226 ROWAN NA City of Louisville KY 40203,Vehicle Fire,132,132 - Road freight or transport vehicle fire,2000,5000,7000,5000,-2000
15911,2015,Summer,6/14/2015,1420 W BROADWAY N/A City of Louisville KY 40203,Structure Fire,118,"118 - Trash or rubbish fire, contained",0,500,500,30000,29500
15917,2015,Summer,6/14/2015,236 S 41ST n/a City of Louisville KY 40212,Structure Fire,111,111 - Building fire,0,35000,35000,35000,0
15932,2015,Summer,6/14/2015,4200 WINNROSE NA City of Louisville KY 40211,Vehicle Fire,131,131 - Passenger vehicle fire,300,5000,5300,5000,-300
16066,2015,Summer,6/15/2015,3108 WOODLAND N/A City of Louisville KY 40211,Structure Fire,111,111 - Building fire,500,0,500,0,-500
16132,2015,Summer,6/16/2015,4160 HAZELWOOD na City of Louisville KY 40215,Outside Fire,160,"160 - Special outside fire, other",0,1000,1000,1000,0
16263,2015,Summer,6/17/2015,4710 S RUTLAND N/A City of Louisville KY 40215,Structure Fire,111,111 - Building fire,400,500,900,80000,79100
16286,2015,Summer,6/17/2015,S 20TH City of Louisville KY 40203,Vehicle Fire,138,138 - Off-road vehicle or heavy equipment fire,0,3000,3000,5000,2000
16312,2015,Summer,6/18/2015,4139 W MARKET n/a City of Louisville KY 40212,Structure Fire,111,111 - Building fire,400,0,400,0,-400
16398,2015,Summer,6/18/2015,3521 W MUHAMMAD ALI N/A City of Louisville KY 40212,Structure Fire,111,111 - Building fire,200,500,700,37080,36380
16439,2015,Summer,6/18/2015,3202 TAYLOR n/a City of Louisville KY 40215,Vehicle Fire,131,131 - Passenger vehicle fire,0,2000,2000,2000,0
16439,2015,Summer,6/18/2015,3202 TAYLOR n/a City of Louisville KY 40215,Structure Fire,111,111 - Building fire,0,5000,5000,20000,15000
16612,2015,Summer,6/20/2015,1372 POPLAR LEVEL n/a City of Louisville KY 40217,Structure Fire,112,112 - Fires in structure other than in a building,1000,0,1000,0,-1000
16637,2015,Summer,6/20/2015,1800 W HILL N/ A City of Louisville KY 40210,Vehicle Fire,131,131 - Passenger vehicle fire,0,2000,2000,4000,2000
16648,2015,Summer,6/20/2015,654 S 38TH n/a City of Louisville KY 40211,Outside Fire,151,"151 - Outside rubbish, trash or waste fire",0,50,50,50,0
16705,2015,Summer,6/21/2015,I 264 East City of Louisville KY 40218,Vehicle Fire,131,131 - Passenger vehicle fire,0,2000,2000,2000,0
16790,2015,Summer,6/22/2015,48 COLLEGE 48 City of Louisville KY 40203,Structure Fire,111,111 - Building fire,500,10000,10500,19050,8550
16852,2015,Summer,6/22/2015,1247 CATALPA 209 City of Louisville KY 40211,Structure Fire,113,"113 - Cooking fire, confined to container",500,500,1000,412750,411750
16932,2015,Summer,6/23/2015,1701 BERRY na City of Louisville KY 40215,Vehicle Fire,131,131 - Passenger vehicle fire,0,16000,16000,16000,0
16932,2015,Summer,6/23/2015,1701 BERRY na City of Louisville KY 40215,Vehicle Fire,131,131 - Passenger vehicle fire,0,500,500,80000,79500
17056,2015,Summer,6/24/2015,4444 ESTHER outside City of Louisville KY 40216,Vehicle Fire,131,131 - Passenger vehicle fire,200,1500,1700,2000,300
17058,2015,Summer,6/24/2015,2727 BANK n/a City of Louisville KY 40212,Outside Fire,151,"151 - Outside rubbish, trash or waste fire",0,250,250,250,0
17058,2015,Summer,6/24/2015,2727 BANK n/a City of Louisville KY 40212,Outside Fire,151,"151 - Outside rubbish, trash or waste fire",0,250,250,250,0
17095,2015,Summer,6/25/2015,3638 GREENWOOD N/A City of Louisville KY 40211,Vehicle Fire,130,"130 - Mobile property (vehicle) fire, other",0,1000,1000,1000,0
17109,2015,Summer,6/25/2015,7 NICHOLS n/a City of Louisville KY 40215,Vehicle Fire,131,131 - Passenger vehicle fire,0,1000,1000,1500,500
17400,2015,Summer,6/27/2015,4615 S RUTLAND n/a City of Louisville KY 40215,Vehicle Fire,131,131 - Passenger vehicle fire,0,5000,5000,5000,0
17452,2015,Summer,6/28/2015,4327 HAZELWOOD 2A City of Louisville KY 40215,Structure Fire,111,111 - Building fire,150,100,250,280740,280490
17482,2015,Summer,6/28/2015,5728 MORRISON n/a City of Louisville KY 40214,Structure Fire,111,111 - Building fire,20000,50000,70000,113600,43600
17493,2015,Summer,6/28/2015,S BROOK City of Louisville KY 40202,Vehicle Fire,131,131 - Passenger vehicle fire,0,10000,10000,10000,0
17528,2015,Summer,6/29/2015,2617 W CHESTNUT n/a City of Louisville KY 40211,Structure Fire,111,111 - Building fire,10000,20000,30000,41640,11640
17535,2015,Summer,6/29/2015,4407 ELLIOTT 3 City of Louisville KY 40211,Structure Fire,111,111 - Building fire,0,5000,5000,5000,0
17632,2015,Summer,6/29/2015,1500 CENTRAL n/a City of Louisville KY 40208,Vehicle Fire,131,131 - Passenger vehicle fire,0,1000,1000,8000,7000
17528,2015,Summer,6/29/2015,2615 W CHESTNUT n/a City of Louisville KY 40211,Structure Fire,111,111 - Building fire,0,2000,2000,41320,39320
17528,2015,Summer,6/29/2015,2619 W CHESTNUT n/a City of Louisville KY 40211,Structure Fire,111,111 - Building fire,0,500,500,36000,35500
17708,2015,Summer,6/30/2015,1115 LONGFIELD NA City of Louisville KY 40215,Structure Fire,111,111 - Building fire,1000,10000,11000,20000,9000
17867,2015,Summer,7/2/2015,1133 S 2ND N/A City of Louisville KY 40203,Structure Fire,111,111 - Building fire,0,160410,160410,160410,0
18068,2015,Summer,7/4/2015,1614 CYPRESS 0 City of Louisville KY 40210,Structure Fire,112,112 - Fires in structure other than in a building,0,1500,1500,3500,2000
18350,2015,Summer,7/6/2015,2237 OSAGE None City of Louisville KY 40210,Structure Fire,111,111 - Building fire,5000,15000,20000,32160,12160
18405,2015,Summer,7/7/2015,2710 W BROADWAY n/a City of Louisville KY 40211,Vehicle Fire,131,131 - Passenger vehicle fire,0,400,400,800,400
18478,2015,Summer,7/8/2015,416 S 26TH n/a City of Louisville KY 40212,Vehicle Fire,131,131 - Passenger vehicle fire,0,500,500,30000,29500
18622,2015,Summer,7/9/2015,1951 MEADOWCREEK N/A City of Louisville KY 40218,Structure Fire,111,111 - Building fire,5000,30000,35000,120000,85000
18662,2015,Summer,7/9/2015,2900BLK NEPPERHAN N/A City of Louisville KY 40218,Vehicle Fire,131,131 - Passenger vehicle fire,0,8000,8000,16000,8000
18697,2015,Summer,7/10/2015,1951 MEADOWCREEK N/A City of Louisville KY 40218,Structure Fire,111,111 - Building fire,7000,25000,32000,120000,88000
18773,2015,Summer,7/10/2015,2324 MAGAZINE 2nd floor City of Louisville KY 40211,Structure Fire,112,112 - Fires in structure other than in a building,50,0,50,0,-50
18838,2015,Summer,7/11/2015,1316 ARCADE n/a City of Louisville KY 40215,Structure Fire,111,111 - Building fire,10000,20000,30000,60000,30000
18876,2015,Summer,7/11/2015,I 264 West N/A City of Kingsley KY 40205,Vehicle Fire,131,131 - Passenger vehicle fire,0,300,300,2000,1700
18988,2015,Summer,7/12/2015,PRESTON City of Audubon Park KY 40213,Vehicle Fire,131,131 - Passenger vehicle fire,0,2000,2000,2000,0
19086,2015,Summer,7/13/2015,7900 SHELBYVILLE n/a City of Bancroft KY 40222,Vehicle Fire,131,131 - Passenger vehicle fire,0,1700,1700,1700,0
19318,2015,Summer,7/15/2015,2820 DEL RIO 2 City of Cambridge KY 40220,Outside Fire,160,"160 - Special outside fire, other",10,100,110,100,-10
19371,2015,Summer,7/15/2015,541 INDUSTRY 480 City of Louisville KY 40208,Structure Fire,111,111 - Building fire,10000,10000,20000,2187500,2167500
19306,2015,Summer,7/15/2015,610 S 28TH n/a City of Louisville KY 40211,Structure Fire,111,111 - Building fire,5000,20000,25000,20000,-5000
19433,2015,Summer,7/16/2015,S 4TH City of Louisville KY 40208,Vehicle Fire,131,131 - Passenger vehicle fire,0,15000,15000,15000,0
19445,2015,Summer,7/16/2015,1720 W CHESTNUT 3 City of Louisville KY 40203,Structure Fire,113,"113 - Cooking fire, confined to container",500,500,1000,60000,59000
19466,2015,Summer,7/16/2015,2323 ROWAN N/A City of Louisville KY 40212,Structure Fire,111,111 - Building fire,0,1000,1000,22990,21990
19511,2015,Summer,7/17/2015,4440 W BROADWAY na City of Louisville KY 40211,Vehicle Fire,131,131 - Passenger vehicle fire,0,5000,5000,5000,0
19518,2015,Summer,7/17/2015,E MAIN NA City of Louisville KY 40202,Structure Fire,111,111 - Building fire,1000,1000,2000,1000,-1000
19709,2015,Summer,7/18/2015,6500 ESTELE 1 City of Louisville KY 40214,Structure Fire,111,111 - Building fire,1000,15000,16000,79600,63600
19781,2015,Summer,7/18/2015,3827 JEWELL na City of Louisville KY 40212,Vehicle Fire,131,131 - Passenger vehicle fire,0,1500,1500,1500,0
19797,2015,Summer,7/19/2015,3044 W BROADWAY na City of Louisville KY 40211,Structure Fire,111,111 - Building fire,2000,12000,14000,132000,118000
19882,2015,Summer,7/19/2015,1600 STEVENS basement City of Kingsley KY 40205,Structure Fire,111,111 - Building fire,500,500,1000,500,-500
19937,2015,Summer,7/20/2015,1487 FRANKFORT n/a City of Louisville KY 40206,Vehicle Fire,131,131 - Passenger vehicle fire,0,2000,2000,2000,0
20059,2015,Summer,7/21/2015,611 INDUSTRY n/a City of Louisville KY 40208,Vehicle Fire,131,131 - Passenger vehicle fire,0,3000,3000,3000,0
20068,2015,Summer,7/21/2015,3605 GEORGETOWN 2 City of Louisville KY 40215,Structure Fire,111,111 - Building fire,500,5000,5500,220000,214500
20082,2015,Summer,7/21/2015,1840 ROANOKE N/A City of Kingsley KY 40205,Vehicle Fire,131,131 - Passenger vehicle fire,0,2000,2000,2000,0
20112,2015,Summer,7/22/2015,133 N 26TH none City of Louisville KY 40212,Structure Fire,111,111 - Building fire,0,5000,5000,24300,19300
20192,2015,Summer,7/22/2015,1801 BICKNELL na City of Louisville KY 40215,Structure Fire,111,111 - Building fire,200,1500,1700,1500,-200
20199,2015,Summer,7/22/2015,1240 CEDAR 1240 City of Louisville KY 40203,Structure Fire,111,111 - Building fire,500,1000,1500,5550,4050
20254,2015,Summer,7/23/2015,1604 THORNBERRY n/a City of Louisville KY 40215,Structure Fire,111,111 - Building fire,0,5000,5000,41000,36000
20397,2015,Summer,7/25/2015,3668 CRAIG n/a City of Louisville KY 40215,Structure Fire,111,111 - Building fire,0,35000,35000,48890,13890
20415,2015,Summer,7/25/2015,612 E KENTUCKY n/a City of Louisville KY 40203,Outside Fire,161,161 - Outside storage fire,500,2000,2500,2000,-500
20397,2015,Summer,7/25/2015,3666 CRAIG n/a City of Louisville KY 40215,Structure Fire,111,111 - Building fire,0,5000,5000,50000,45000
20569,2015,Summer,7/26/2015,I 65 City of Louisville KY 40217,Vehicle Fire,131,131 - Passenger vehicle fire,500,5000,5500,5000,-500
20627,2015,Summer,7/27/2015,1550 LINCOLN N/A City of Audubon Park KY 40213,Structure Fire,111,111 - Building fire,500,0,500,52000,51500
20763,2015,Summer,7/28/2015,300 S 38TH na City of Louisville KY 40212,Vehicle Fire,130,"130 - Mobile property (vehicle) fire, other",0,2000,2000,2000,0
20811,2015,Summer,7/28/2015,3901 VERMONT na City of Louisville KY 40211,Vehicle Fire,131,131 - Passenger vehicle fire,0,1000,1000,1000,0
20822,2015,Summer,7/28/2015,2310 CRITTENDEN na City of Louisville KY 40217,Outside Fire,142,142 - Brush or brush-and-grass mixture fire,0,1000,1000,1000,0
20866,2015,Summer,7/29/2015,723 VINE n/a City of Louisville KY 40204,Structure Fire,111,111 - Building fire,10000,50000,60000,100000,40000
20881,2015,Summer,7/29/2015,1515 ARLING N/A City of Louisville KY 40215,Structure Fire,111,111 - Building fire,8000,25000,33000,75000,42000
20990,2015,Summer,7/30/2015,911 GRADE NA City of Audubon Park KY 40213,Vehicle Fire,131,131 - Passenger vehicle fire,250,2000,2250,2000,-250
20996,2015,Summer,7/30/2015,990 BAXTER N/A City of Louisville KY 40204,Vehicle Fire,132,132 - Road freight or transport vehicle fire,0,100,100,100,0
21046,2015,Summer,7/31/2015,1600 BRASHEAR N/A City of Louisville KY 40210,Vehicle Fire,130,"130 - Mobile property (vehicle) fire, other",0,300,300,300,0
21046,2015,Summer,7/31/2015,1600 BRASHEAR N/A City of Louisville KY 40210,Vehicle Fire,131,131 - Passenger vehicle fire,0,300,300,300,0
21165,2015,Summer,7/31/2015,1238 S PRESTON n/a City of Louisville KY 40203,Structure Fire,111,111 - Building fire,100,500,600,25000,24400
21189,2015,Autumn,8/1/2015,920 CHEROKEE n/a City of Louisville KY 40204,Structure Fire,111,111 - Building fire,100,200,300,270500,270200
21214,2015,Autumn,8/1/2015,1623 WILSON N/A City of Louisville KY 40210,Outside Fire,160,"160 - Special outside fire, other",0,1000,1000,1000,0
21230,2015,Autumn,8/1/2015,113 N SHAWNEE na City of Louisville KY 40212,Structure Fire,111,111 - Building fire,20000,56380,76380,56380,-20000
21230,2015,Autumn,8/1/2015,115 N SHAWNEE na City of Louisville KY 40212,Structure Fire,111,111 - Building fire,0,2500,2500,56000,53500
21313,2015,Autumn,8/2/2015,S 15TH City of Louisville KY 40210,Vehicle Fire,131,131 - Passenger vehicle fire,500,3000,3500,4500,1000
21331,2015,Autumn,8/2/2015,3409 W JEFFERSON na City of Louisville KY 40212,Structure Fire,113,"113 - Cooking fire, confined to container",500,0,500,NULL,NULL
21412,2015,Autumn,8/3/2015,21 COLLEGE na City of Louisville KY 40203,Structure Fire,111,111 - Building fire,3000,15000,18000,16000,-2000
21538,2015,Autumn,8/4/2015,2216 STANDARD n/a City of Louisville KY 40210,Structure Fire,111,111 - Building fire,0,25000,25000,25000,0
21538,2015,Autumn,8/4/2015,2218 STANDARD n/a City of Louisville KY 40210,Structure Fire,111,111 - Building fire,0,5000,5000,40000,35000
21688,2015,Autumn,8/5/2015,3435 7TH STREET parking lot City of Louisville KY 40216,Vehicle Fire,131,131 - Passenger vehicle fire,0,3000,3000,3000,0
21819,2015,Autumn,8/7/2015,BRECKENRIDGE n/a City of Cambridge KY 40220,Vehicle Fire,131,131 - Passenger vehicle fire,0,1000,1000,1000,0
21905,2015,Autumn,8/8/2015,2300 BROWNSBORO N/A City of Louisville KY 40206,Vehicle Fire,131,131 - Passenger vehicle fire,0,1500,1500,4000,2500
21924,2015,Autumn,8/8/2015,W BROADWAY City of Louisville KY 40211,Vehicle Fire,131,131 - Passenger vehicle fire,0,1000,1000,2000,1000
21971,2015,Autumn,8/8/2015,1743 W KENTUCKY n/a City of Louisville KY 40210,Structure Fire,111,111 - Building fire,0,100,100,30000,29900
22020,2015,Autumn,8/9/2015,2531 TAYLORSVILLE n/a City of Kingsley KY 40205,Structure Fire,111,111 - Building fire,0,400,400,1000000,999600
22050,2015,Autumn,8/9/2015,3254 GOLDEN TURTLE n/a City of Louisville KY 40218,Outside Fire,154,154 - Dumpster or other outside trash receptacle fire,0,50,50,500,450
22202,2015,Autumn,8/10/2015,741 FRANKLIN none City of Louisville KY 40202,Structure Fire,111,111 - Building fire,5000,5000,10000,370000,360000
22281,2015,Autumn,8/11/2015,I 264 West City of Louisville KY 40215,Vehicle Fire,131,131 - Passenger vehicle fire,0,1500,1500,12000,10500
22333,2015,Autumn,8/12/2015,723 E ORMSBY n/a City of Louisville KY 40203,Structure Fire,111,111 - Building fire,0,10000,10000,55000,45000
22409,2015,Autumn,8/13/2015,1614 CYPRESS N/A City of Louisville KY 40210,Outside Fire,160,"160 - Special outside fire, other",1000,0,1000,0,-1000
22445,2015,Autumn,8/13/2015,1501 BELLAMY 203 City of Louisville KY 40208,Structure Fire,111,111 - Building fire,0,2000,2000,700000,698000
22706,2015,Autumn,8/15/2015,1614 CYPRESS N/A City of Louisville KY 40210,Structure Fire,118,"118 - Trash or rubbish fire, contained",0,30,30,10000,9970
22774,2015,Autumn,8/16/2015,1000 MARY none City of Louisville KY 40204,Vehicle Fire,131,131 - Passenger vehicle fire,0,1000,1000,1000,0
22908,2015,Autumn,8/17/2015,2407 SHERRY n/a City of Louisville KY 40217,Vehicle Fire,131,131 - Passenger vehicle fire,0,20000,20000,20000,0
22925,2015,Autumn,8/17/2015,2501 S 4TH bldg.1000-9000 City of Louisville KY 40208,Vehicle Fire,131,131 - Passenger vehicle fire,0,2500,2500,2500,0
22938,2015,Autumn,8/17/2015,1844 GRAND n/a City of Louisville KY 40210,Structure Fire,113,"113 - Cooking fire, confined to container",300,0,300,0,-300
22969,2015,Autumn,8/18/2015,947 S 7TH backyard City of Louisville KY 40203,Outside Fire,151,"151 - Outside rubbish, trash or waste fire",0,300,300,300,0
23158,2015,Autumn,8/20/2015,3022 W KENTUCKY 0 City of Louisville KY 40211,Vehicle Fire,131,131 - Passenger vehicle fire,500,8000,8500,8000,-500
23168,2015,Autumn,8/20/2015,522 S 18TH na City of Louisville KY 40203,Structure Fire,111,111 - Building fire,0,10000,10000,50000,40000
23232,2015,Autumn,8/20/2015,1618 S 30TH N/A City of Louisville KY 40211,Structure Fire,113,"113 - Cooking fire, confined to container",0,5000,5000,41700,36700
23255,2015,Autumn,8/20/2015,1962 GOLDSMITH 2 City of Louisville KY 40218,Structure Fire,112,112 - Fires in structure other than in a building,500,500,1000,500,-500
23484,2015,Autumn,8/23/2015,1203 S 1ST 2 City of Louisville KY 40203,Structure Fire,112,112 - Fires in structure other than in a building,200,0,200,NULL,NULL
23510,2015,Autumn,8/23/2015,912 BRENTWOOD n/a City of Louisville KY 40215,Structure Fire,113,"113 - Cooking fire, confined to container",50,0,50,0,-50
23569,2015,Autumn,8/23/2015,900 LAMPTON N/A City of Louisville KY 40204,Vehicle Fire,131,131 - Passenger vehicle fire,0,12000,12000,12000,0
23612,2015,Autumn,8/24/2015,1600 W ST CATHERINE 0 City of Louisville KY 40210,Structure Fire,118,"118 - Trash or rubbish fire, contained",0,50,50,4000,3950
23792,2015,Autumn,8/26/2015,914 W EVELYN n/a City of Louisville KY 40215,Vehicle Fire,131,131 - Passenger vehicle fire,0,5000,5000,5000,0
23842,2015,Autumn,8/26/2015,W BROADWAY City of Louisville KY 40203,Vehicle Fire,131,131 - Passenger vehicle fire,0,2500,2500,2500,0
23887,2015,Autumn,8/27/2015,710 S 42ND N/A City of Louisville KY 40211,Structure Fire,111,111 - Building fire,10000,5000,15000,49180,34180
23924,2015,Autumn,8/27/2015,521 S 27TH na City of Louisville KY 40211,Structure Fire,113,"113 - Cooking fire, confined to container",500,500,1000,31640,30640
24036,2015,Autumn,8/28/2015,1816 W KENTUCKY n/a City of Louisville KY 40210,Vehicle Fire,130,"130 - Mobile property (vehicle) fire, other",0,100,100,100,0
24121,2015,Autumn,8/29/2015,CYPRESS City of Louisville KY 40210,Vehicle Fire,138,138 - Off-road vehicle or heavy equipment fire,0,1500,1500,1500,0
24121,2015,Autumn,8/29/2015,CYPRESS City of Louisville KY 40210,Vehicle Fire,138,138 - Off-road vehicle or heavy equipment fire,0,600,600,600,0
24175,2015,Autumn,8/30/2015,613 SOUTHWESTERN na City of Louisville KY 40211,Vehicle Fire,131,131 - Passenger vehicle fire,3000,5000,8000,5000,-3000
24181,2015,Autumn,8/30/2015,4100 S BROOK n/a City of Louisville KY 40214,Structure Fire,111,111 - Building fire,4000,20000,24000,80000,56000
24202,2015,Autumn,8/30/2015,I 264 East n/a City of Audubon Park KY 40213,Vehicle Fire,131,131 - Passenger vehicle fire,600,2000,2600,5000,2400
24215,2015,Autumn,8/30/2015,CROP City of Louisville KY 40212,Vehicle Fire,138,138 - Off-road vehicle or heavy equipment fire,0,200,200,200,0
24270,2015,Autumn,8/31/2015,638 S 26TH na City of Louisville KY 40211,Structure Fire,111,111 - Building fire,2000,10000,12000,16000,4000
24324,2015,Autumn,8/31/2015,672 S 44TH 0 City of Louisville KY 40211,Vehicle Fire,131,131 - Passenger vehicle fire,8000,0,8000,0,-8000
24457,2015,Autumn,9/1/2015,2524 ST CECILIA NA City of Louisville KY 40212,Structure Fire,111,111 - Building fire,10000,30000,40000,33040,-6960
24542,2015,Autumn,9/2/2015,1268 CHEROKEE N/A City of Louisville KY 40204,Outside Fire,150,"150 - Outside rubbish fire, other",0,50,50,6000,5950
24869,2015,Autumn,9/5/2015,3519 GEORGETOWN 5 City of Louisville KY 40215,Structure Fire,111,111 - Building fire,500,500,1000,194670,193670
24820,2015,Autumn,9/5/2015,MELLWOOD City of Louisville KY 40206,Vehicle Fire,131,131 - Passenger vehicle fire,0,5000,5000,5000,0
24874,2015,Autumn,9/6/2015,732 DEARBORN na City of Louisville KY 40211,Structure Fire,111,111 - Building fire,1000,1000,2000,62600,60600
24966,2015,Autumn,9/6/2015,S 26TH City of Louisville KY 40212,Vehicle Fire,131,131 - Passenger vehicle fire,200,2000,2200,2000,-200
24984,2015,Autumn,9/7/2015,4221 GRAND n/a City of Louisville KY 40211,Vehicle Fire,131,131 - Passenger vehicle fire,100,6300,6400,6300,-100
24988,2015,Autumn,9/7/2015,2408 ELLIOTT NA City of Louisville KY 40211,Vehicle Fire,131,131 - Passenger vehicle fire,0,5000,5000,5000,0
25090,2015,Autumn,9/8/2015,1146 S 6TH 3 City of Louisville KY 40203,Structure Fire,111,111 - Building fire,0,1000,1000,200000,199000
25154,2015,Autumn,9/8/2015,I 264 East na City of Louisville KY 40212,Vehicle Fire,131,131 - Passenger vehicle fire,0,3000,3000,3000,0
25198,2015,Autumn,9/9/2015,434 EASTERN n/a City of Louisville KY 40217,Vehicle Fire,131,131 - Passenger vehicle fire,100,2000,2100,2000,-100
25236,2015,Autumn,9/9/2015,S JACKSON City of Louisville KY 40203,Vehicle Fire,131,131 - Passenger vehicle fire,0,200,200,200,0
25329,2015,Autumn,9/10/2015,3416 LINWOOD N/A City of Louisville KY 40211,Structure Fire,111,111 - Building fire,0,1000,1000,20000,19000
25601,2015,Autumn,9/13/2015,1633 W JEFFERSON N/A City of Louisville KY 40203,FALSE,600,"600 - Good intent call, other",0,2000,2000,2000,0
25604,2015,Autumn,9/13/2015,427 ATWOOD n/a City of Louisville KY 40217,Outside Fire,160,"160 - Special outside fire, other",0,800,800,800,0
25637,2015,Autumn,9/14/2015,2214 DUNCAN NA City of Louisville KY 40212,Structure Fire,111,111 - Building fire,0,12500,12500,12500,0
25654,2015,Autumn,9/14/2015,1000 E MAIN na City of Louisville KY 40206,Vehicle Fire,131,131 - Passenger vehicle fire,100,1000,1100,4000,2900
25637,2015,Autumn,9/14/2015,2216 DUNCAN NA City of Louisville KY 40212,Structure Fire,111,111 - Building fire,0,4000,4000,26850,22850
25813,2015,Autumn,9/15/2015,821 IROQUOIS n/a City of Louisville KY 40214,Structure Fire,111,111 - Building fire,100,0,100,0,-100
25920,2015,Autumn,9/16/2015,1114 S 4TH 508 City of Louisville KY 40203,Structure Fire,113,"113 - Cooking fire, confined to container",0,1000,1000,1000000,999000
26017,2015,Autumn,9/17/2015,2713 SHEILA n/a City of Cambridge KY 40220,Structure Fire,111,111 - Building fire,20000,70000,90000,124000,34000
26034,2015,Autumn,9/18/2015,4309 ELLIOTT 0 City of Louisville KY 40211,Vehicle Fire,131,131 - Passenger vehicle fire,1000,20000,21000,20000,-1000
26041,2015,Autumn,9/18/2015,1301 BELMAR NA City of Audubon Park KY 40213,Structure Fire,111,111 - Building fire,1000,2500,3500,2500,-1000
26057,2015,Autumn,9/18/2015,2304 W MUHAMMAD ALI 1 City of Louisville KY 40212,Structure Fire,111,111 - Building fire,500,1000,1500,44500,43000
26034,2015,Autumn,9/18/2015,S 44TH City of Louisville KY 40211,Vehicle Fire,131,131 - Passenger vehicle fire,0,1000,1000,3000,2000
26248,2015,Autumn,9/20/2015,4331 LONSDALE Garage City of Louisville KY 40215,Structure Fire,111,111 - Building fire,5000,10000,15000,10000,-5000
26248,2015,Autumn,9/20/2015,1418 WOODY Garage City of Louisville KY 40215,Outside Fire,160,"160 - Special outside fire, other",0,400,400,10000,9600
26248,2015,Autumn,9/20/2015,1419 Oakwood Garage City of Louisville KY 40215,Outside Fire,160,"160 - Special outside fire, other",0,400,400,1000,600
26248,2015,Autumn,9/20/2015,1419 1/2 LONSDALE Garage City of Louisville KY 40215,Outside Fire,160,"160 - Special outside fire, other",0,300,300,8000,7700
26461,2015,Autumn,9/22/2015,2108 W ORMSBY n/a City of Louisville KY 40210,Structure Fire,111,111 - Building fire,2000,16750,18750,19250,500
26481,2015,Autumn,9/22/2015,3514 HALE NA City of Louisville KY 40211,Structure Fire,111,111 - Building fire,5000,10000,15000,35860,20860
26530,2015,Autumn,9/23/2015,1208 S PRESTON N/A City of Louisville KY 40203,Vehicle Fire,131,131 - Passenger vehicle fire,200,2500,2700,8000,5300
26539,2015,Autumn,9/23/2015,3702 NOBLITT 3 City of Louisville KY 40218,Structure Fire,113,"113 - Cooking fire, confined to container",500,500,1000,500,-500
26561,2015,Autumn,9/23/2015,217 W ST CATHERINE na City of Louisville KY 40203,Structure Fire,111,111 - Building fire,0,1500,1500,200000,198500
26582,2015,Autumn,9/23/2015,S 1ST City of Louisville KY 40202,Vehicle Fire,131,131 - Passenger vehicle fire,0,3500,3500,3500,0
26592,2015,Autumn,9/23/2015,208 BONTRESSA na City of Louisville KY 40206,FALSE,160,"160 - Special outside fire, other",3000,0,3000,NULL,NULL
26596,2015,Autumn,9/23/2015,1233 S 2ND 1 City of Louisville KY 40203,Structure Fire,111,111 - Building fire,3000,20000,23000,238000,215000
26540,2015,Autumn,9/23/2015,2129 GARLAND na City of Louisville KY 40211,Structure Fire,111,111 - Building fire,0,500,500,10000,9500
26650,2015,Autumn,9/24/2015,2141 SYCAMORE n/a City of Louisville KY 40206,Structure Fire,116,"116 - Fuel burner/boiler malfunction, fire confined",0,1000,1000,900000,899000
26792,2015,Autumn,9/25/2015,434 S 12TH n/a City of Louisville KY 40203,Structure Fire,113,"113 - Cooking fire, confined to container",10,0,10,0,-10
27162,2015,Autumn,9/28/2015,1802 W OAK 0 City of Louisville KY 40210,Structure Fire,111,111 - Building fire,0,50,50,100,50
27164,2015,Autumn,9/28/2015,737 M 0 City of Louisville KY 40208,Vehicle Fire,131,131 - Passenger vehicle fire,0,1800,1800,1800,0
27364,2015,Autumn,10/1/2015,400B W CHESTNUT N/A City of Louisville KY 40202,Vehicle Fire,131,131 - Passenger vehicle fire,500,4000,4500,4000,-500
27412,2015,Autumn,10/1/2015,1019 SALE n/a City of Louisville KY 40215,Structure Fire,111,111 - Building fire,5000,20000,25000,49780,24780
27421,2015,Autumn,10/1/2015,607 S 44TH 3 City of Louisville KY 40211,Structure Fire,111,111 - Building fire,100,200,300,550000,549700
27432,2015,Autumn,10/1/2015,402 N 38TH na City of Louisville KY 40212,Vehicle Fire,131,131 - Passenger vehicle fire,0,1000,1000,1000,0
27473,2015,Autumn,10/2/2015,1528 S 31ST N/A City of Louisville KY 40211,Vehicle Fire,131,131 - Passenger vehicle fire,0,10000,10000,10000,0
27473,2015,Autumn,10/2/2015,1528 S 31ST N/A City of Louisville KY 40211,Vehicle Fire,131,131 - Passenger vehicle fire,0,500,500,2000,1500
27822,2015,Autumn,10/5/2015,2025 BROWNSBORO 110 City of Louisville KY 40206,Structure Fire,113,"113 - Cooking fire, confined to container",200,0,200,0,-200
27860,2015,Autumn,10/6/2015,1129 CAMDEN n/a City of Louisville KY 40215,Structure Fire,111,111 - Building fire,40000,85000,125000,85000,-40000
27862,2015,Autumn,10/6/2015,1650 GALLAGHER 0 City of Louisville KY 40210,Structure Fire,112,112 - Fires in structure other than in a building,0,1000,1000,1000,0
27946,2015,Autumn,10/7/2015,1770 DUMESNIL N/A City of Louisville KY 40210,Structure Fire,113,"113 - Cooking fire, confined to container",1000,500,1500,34000,32500
28007,2015,Autumn,10/7/2015,3316 NOE 22 City of Cambridge KY 40220,Structure Fire,111,111 - Building fire,10000,50000,60000,400000,340000
28064,2015,Autumn,10/8/2015,S SHELBY City of Louisville KY 40217,Vehicle Fire,131,131 - Passenger vehicle fire,350,3000,3350,3000,-350
28183,2015,Autumn,10/9/2015,I 264 East n/a City of Audubon Park KY 40213,Vehicle Fire,130,"130 - Mobile property (vehicle) fire, other",0,3000,3000,5000,2000
28186,2015,Autumn,10/9/2015,2018 PEABODY 10 City of Louisville KY 40218,Structure Fire,111,111 - Building fire,100,0,100,500000,499900
28434,2015,Autumn,10/11/2015,2407 ROWAN N/A City of Louisville KY 40212,Structure Fire,111,111 - Building fire,0,20000,20000,24780,4780
28434,2015,Autumn,10/11/2015,2405 ROWAN N/A City of Louisville KY 40212,Structure Fire,111,111 - Building fire,0,5000,5000,12700,7700
28526,2015,Autumn,10/12/2015,2339 W CHESTNUT n/a City of Louisville KY 40211,Structure Fire,112,112 - Fires in structure other than in a building,1500,0,1500,17155,15655
28586,2015,Autumn,10/13/2015,928 LOGAN N/A City of Louisville KY 40204,Structure Fire,111,111 - Building fire,3000,30000,33000,40000,7000
28614,2015,Autumn,10/13/2015,1217 CYPRESS n/a City of Louisville KY 40211,Structure Fire,118,"118 - Trash or rubbish fire, contained",500,0,500,NULL,NULL
28618,2015,Autumn,10/13/2015,1536 DUMESNIL n/a City of Louisville KY 40210,Structure Fire,111,111 - Building fire,5000,15000,20000,15000,-5000
28678,2015,Autumn,10/13/2015,1432 LEVERING n/a City of Louisville KY 40208,Vehicle Fire,131,131 - Passenger vehicle fire,0,1391,1391,1391,0
28586,2015,Autumn,10/13/2015,932 LOGAN N/A City of Louisville KY 40204,Structure Fire,111,111 - Building fire,0,500,500,27500,27000
28680,2015,Autumn,10/14/2015,2126 PEABODY N/A City of Louisville KY 40218,Vehicle Fire,131,131 - Passenger vehicle fire,1000,11000,12000,11000,-1000
28720,2015,Autumn,10/14/2015,I 264 West City of Audubon Park KY 40213,Vehicle Fire,131,131 - Passenger vehicle fire,0,3000,3000,3000,0
28746,2015,Autumn,10/14/2015,2306 W MADISON na City of Louisville KY 40211,Structure Fire,111,111 - Building fire,0,500,500,5000,4500
28764,2015,Autumn,10/14/2015,1924 LYTLE N/A City of Louisville KY 40203,Structure Fire,111,111 - Building fire,7000,22000,29000,28200,-800
28774,2015,Autumn,10/15/2015,"1660 BEECHWOOD 101, 102, 202 City of Louisville KY 40204",Structure Fire,111,111 - Building fire,1000,151000,152000,301500,149500
28774,2015,Autumn,10/15/2015,1230 BARDSTOWN N/A City of Louisville KY 40204,Structure Fire,111,111 - Building fire,75000,250000,325000,400000,75000
28888,2015,Autumn,10/16/2015,931 DIXIE N/A City of Louisville KY 40210,Structure Fire,111,111 - Building fire,1000,2500,3500,375000,371500
28960,2015,Autumn,10/16/2015,2841 HIKES 110 City of Louisville KY 40218,Structure Fire,111,111 - Building fire,0,1000,1000,1000,0
28961,2015,Autumn,10/16/2015,700 E OAK N/A City of Louisville KY 40203,Vehicle Fire,130,"130 - Mobile property (vehicle) fire, other",0,2000,2000,2500,500
28969,2015,Autumn,10/16/2015,1203 LILLIAN n/a City of Louisville KY 40208,Structure Fire,111,111 - Building fire,0,500,500,8000,7500
29113,2015,Autumn,10/18/2015,I 64 West N/A City of Louisville KY 40206,Vehicle Fire,131,131 - Passenger vehicle fire,0,1500,1500,2000,500
29145,2015,Autumn,10/18/2015,1850 CARL na City of Louisville KY 40215,Vehicle Fire,131,131 - Passenger vehicle fire,0,4500,4500,4500,0
29156,2015,Autumn,10/18/2015,4308 MALCOLM na City of Louisville KY 40215,Structure Fire,113,"113 - Cooking fire, confined to container",500,0,500,NULL,NULL
29228,2015,Autumn,10/19/2015,I 264 West n/a City of Kingsley KY 40205,Vehicle Fire,131,131 - Passenger vehicle fire,0,1500,1500,1500,0
29241,2015,Autumn,10/19/2015,S JACKSON City of Louisville KY 40202,Structure Fire,120,"120 - Fire in mobile prop. used as a fixed struc., other",0,500,500,500,0
29343,2015,Autumn,10/20/2015,1449 HEMLOCK N/A City of Louisville KY 40211,Structure Fire,111,111 - Building fire,500,0,500,21790,21290
29369,2015,Autumn,10/21/2015,2033 BANK N/A City of Louisville KY 40203,Structure Fire,111,111 - Building fire,200,0,200,0,-200
29434,2015,Autumn,10/21/2015,4 COLONIAL OAKS 4 City of Louisville KY 40214,Structure Fire,113,"113 - Cooking fire, confined to container",250,0,250,0,-250
29496,2015,Autumn,10/22/2015,I 264 West n/a City of Louisville KY 40209,Vehicle Fire,131,131 - Passenger vehicle fire,500,2000,2500,2000,-500
29504,2015,Autumn,10/22/2015,2129 TREVILIAN n/a City of Kingsley KY 40205,Structure Fire,111,111 - Building fire,0,500,500,500,0
29568,2015,Autumn,10/22/2015,1509 OLEANDA 4 City of Louisville KY 40215,Structure Fire,111,111 - Building fire,5000,10000,15000,1015500,1000500
29647,2015,Autumn,10/23/2015,1611 CYPRESS N/A City of Louisville KY 40210,Vehicle Fire,131,131 - Passenger vehicle fire,0,1500,1500,1500,0
29664,2015,Autumn,10/23/2015,2400 COLORADO NA City of Louisville KY 40208,Outside Fire,140,"140 - Natural vegetation fire, other",0,2000,2000,15000,13000
29686,2015,Autumn,10/24/2015,909 E CHESTNUT na City of Louisville KY 40204,Structure Fire,111,111 - Building fire,2500,10000,12500,50000,37500
29740,2015,Autumn,10/24/2015,3120 W KENTUCKY n/a City of Louisville KY 40211,Structure Fire,111,111 - Building fire,1000,30000,31000,60000,29000
29932,2015,Autumn,10/26/2015,1309 HOMEVIEW n/a City of Louisville KY 40215,Structure Fire,113,"113 - Cooking fire, confined to container",200,0,200,0,-200
30038,2015,Autumn,10/27/2015,5462 NEW CUT N/A City of Louisville KY 40214,Structure Fire,111,111 - Building fire,0,10000,10000,1500000,1490000
30045,2015,Autumn,10/28/2015,630 IROQUOIS N/A City of Louisville KY 40214,Structure Fire,111,111 - Building fire,1000,5000,6000,71510,65510
30089,2015,Autumn,10/28/2015,728 CECIL na City of Louisville KY 40211,Vehicle Fire,131,131 - Passenger vehicle fire,0,7000,7000,7000,0
30101,2015,Autumn,10/28/2015,1534 S 9TH N/A City of Louisville KY 40208,Structure Fire,111,111 - Building fire,200,1000,1200,60000,58800
30116,2015,Autumn,10/28/2015,4503 HAZELWOOD n/a City of Louisville KY 40214,Structure Fire,111,111 - Building fire,6000,12500,18500,140000,121500
30134,2015,Autumn,10/29/2015,3437 NEWBURG 3 City of Louisville KY 40218,Structure Fire,111,111 - Building fire,1500,4000,5500,4000,-1500
30136,2015,Autumn,10/29/2015,653 LOUIS COLEMAN JR N/A City of Louisville KY 40211,Structure Fire,111,111 - Building fire,1000,20000,21000,40210,19210
30136,2015,Autumn,10/29/2015,655 LOUIS COLEMAN JR N/A City of Louisville KY 40211,Structure Fire,111,111 - Building fire,0,5000,5000,52000,47000
30258,2015,Autumn,10/30/2015,1623 HASKIN n/a City of Louisville KY 40215,Structure Fire,111,111 - Building fire,1000,5000,6000,75650,69650
30280,2015,Autumn,10/30/2015,I 264 West NA City of Louisville KY 40211,Vehicle Fire,131,131 - Passenger vehicle fire,0,1000,1000,30000,29000
30366,2015,Autumn,10/31/2015,1135 S 1ST n/a City of Louisville KY 40203,Outside Fire,142,142 - Brush or brush-and-grass mixture fire,0,200,200,200,0
30590,2015,Winter,11/2/2015,TAYLOR City of Louisville KY 40208,Vehicle Fire,131,131 - Passenger vehicle fire,100,6000,6100,6000,-100
30619,2015,Winter,11/3/2015,833 HAZEL na City of Louisville KY 40211,Structure Fire,111,111 - Building fire,0,10000,10000,22660,12660
30669,2015,Winter,11/3/2015,513 ROSELANE N/A City of Louisville KY 40203,Vehicle Fire,131,131 - Passenger vehicle fire,0,8000,8000,8000,0
30758,2015,Winter,11/4/2015,307 W FLORENCE 3 City of Louisville KY 40214,Structure Fire,111,111 - Building fire,5000,20000,25000,20000,-5000
30794,2015,Winter,11/4/2015,2126 W CHESTNUT 2 City of Louisville KY 40211,Structure Fire,111,111 - Building fire,1000,1000,2000,1000,-1000
30831,2015,Winter,11/5/2015,I 264 City of Louisville KY 40211,Vehicle Fire,131,131 - Passenger vehicle fire,100,6000,6100,6000,-100
30857,2015,Winter,11/5/2015,642 S 18TH N/A City of Louisville KY 40203,Structure Fire,111,111 - Building fire,0,35000,35000,41500,6500
30967,2015,Winter,11/6/2015,2021 WINGFIELD na City of Louisville KY 40210,Vehicle Fire,131,131 - Passenger vehicle fire,0,6000,6000,6000,0
30984,2015,Winter,11/6/2015,CRITTENDEN City of Louisville KY 40209,Vehicle Fire,131,131 - Passenger vehicle fire,200,2500,2700,2500,-200
31062,2015,Winter,11/7/2015,S 43RD City of Louisville KY 40211,Vehicle Fire,131,131 - Passenger vehicle fire,0,500,500,500,0
31280,2015,Winter,11/9/2015,S 4TH City of Louisville KY 40208,Vehicle Fire,131,131 - Passenger vehicle fire,20,100,120,1000,880
31302,2015,Winter,11/10/2015,1216 BICKNELL na City of Louisville KY 40215,Vehicle Fire,131,131 - Passenger vehicle fire,0,3000,3000,3000,0
31374,2015,Winter,11/11/2015,2614 ALANMEDE n/a City of Kingsley KY 40205,Structure Fire,111,111 - Building fire,10,200,210,100000,99790
31429,2015,Winter,11/11/2015,1543 S 10TH n/a City of Louisville KY 40210,Vehicle Fire,131,131 - Passenger vehicle fire,0,6000,6000,6000,0
31527,2015,Winter,11/12/2015,112 STEVENSON N/A City of Louisville KY 40206,Structure Fire,112,112 - Fires in structure other than in a building,1000,1000,2000,85000,83000
31647,2015,Winter,11/13/2015,224 S 25TH N/A City of Louisville KY 40212,Structure Fire,111,111 - Building fire,6000,12000,18000,17640,-360
31647,2015,Winter,11/13/2015,226 S 25TH N/A City of Louisville KY 40212,Structure Fire,111,111 - Building fire,0,500,500,22390,21890
31661,2015,Winter,11/14/2015,625 E ORMSBY None City of Louisville KY 40203,Vehicle Fire,131,131 - Passenger vehicle fire,0,1000,1000,1000,0
31678,2015,Winter,11/14/2015,3726 TAYLORSVILLE n/a City of Cambridge KY 40220,Vehicle Fire,131,131 - Passenger vehicle fire,0,2100,2100,2100,0
31960,2015,Winter,11/16/2015,1159 S 26TH na City of Louisville KY 40210,Structure Fire,111,111 - Building fire,0,75,75,20000,19925
31964,2015,Winter,11/16/2015,409 E MUHAMMAD ALI 503 City of Louisville KY 40202,Structure Fire,111,111 - Building fire,0,5000,5000,2000000,1995000
31899,2015,Winter,11/16/2015,4700 S 3RD na City of Louisville KY 40214,Structure Fire,111,111 - Building fire,10000,30000,40000,452670,412670
31977,2015,Winter,11/17/2015,TAYLORSVILLE City of Kingsley KY 40205,Vehicle Fire,131,131 - Passenger vehicle fire,0,1000,1000,1000,0
32003,2015,Winter,11/17/2015,1949 ROANOKE None City of Kingsley KY 40205,Structure Fire,111,111 - Building fire,20000,60000,80000,189530,109530
32076,2015,Winter,11/17/2015,323 S 43RD na City of Louisville KY 40212,Vehicle Fire,131,131 - Passenger vehicle fire,3000,4000,7000,4500,-2500
32145,2015,Winter,11/18/2015,2303 W CHESTNUT N/A City of Louisville KY 40211,Structure Fire,111,111 - Building fire,0,100,100,73830,73730
32261,2015,Winter,11/19/2015,W MUHAMMAD ALI City of Louisville KY 40212,Vehicle Fire,131,131 - Passenger vehicle fire,0,4000,4000,4000,0
32272,2015,Winter,11/20/2015,309 E ST CATHERINE N/A City of Louisville KY 40203,Outside Fire,154,154 - Dumpster or other outside trash receptacle fire,0,50,50,50,0
32278,2015,Winter,11/20/2015,2021 PEABODY n/a City of Louisville KY 40218,Vehicle Fire,131,131 - Passenger vehicle fire,0,3000,3000,3000,0
32287,2015,Winter,11/20/2015,212 W COLLINS apt City of Louisville KY 40214,Structure Fire,111,111 - Building fire,2000,25000,27000,85000,58000
32278,2015,Winter,11/20/2015,2021 PEABODY n/a City of Louisville KY 40218,Vehicle Fire,131,131 - Passenger vehicle fire,0,1200,1200,3000,1800
32323,2015,Winter,11/20/2015,E HILL City of Louisville KY 40208,Vehicle Fire,131,131 - Passenger vehicle fire,0,4000,4000,4000,0
32338,2015,Winter,11/20/2015,I 264 East City of Audubon Park KY 40213,Vehicle Fire,131,131 - Passenger vehicle fire,100,6000,6100,6000,-100
32514,2015,Winter,11/22/2015,1926 GOLDSMITH 70 City of Louisville KY 40218,Structure Fire,113,"113 - Cooking fire, confined to container",200,0,200,0,-200
32584,2015,Winter,11/23/2015,3911 TAYLORSVILLE Kmart City of Cambridge KY 40220,Vehicle Fire,132,132 - Road freight or transport vehicle fire,10000,20000,30000,20000,-10000
32791,2015,Winter,11/25/2015,323 SIMMONS N/A City of Louisville KY 40203,Structure Fire,111,111 - Building fire,500,1500,2000,65000,63000
32883,2015,Winter,11/26/2015,1009 S 28TH na City of Louisville KY 40211,Structure Fire,113,"113 - Cooking fire, confined to container",1500,5000,6500,21600,15100
32896,2015,Winter,11/26/2015,I 71 South N/A City of Beechwood Village KY 40207,Vehicle Fire,131,131 - Passenger vehicle fire,0,3000,3000,3000,0
32933,2015,Winter,11/26/2015,2909 PINDELL N/A City of Louisville KY 40217,Structure Fire,111,111 - Building fire,500,0,500,0,-500
33063,2015,Winter,11/28/2015,3602 GREEN MEADOWS B4 City of Louisville KY 40218,Structure Fire,113,"113 - Cooking fire, confined to container",0,1000,1000,1000,0
33099,2015,Winter,11/28/2015,3280 TAYLOR n/a City of Louisville KY 40215,Vehicle Fire,131,131 - Passenger vehicle fire,0,2500,2500,2500,0
33152,2015,Winter,11/29/2015,1772 W HILL n/a City of Louisville KY 40210,Structure Fire,111,111 - Building fire,0,2000,2000,26000,24000
33158,2015,Winter,11/29/2015,432 MONTANA 0 City of Louisville KY 40208,Structure Fire,111,111 - Building fire,0,8000,8000,8000,0
33158,2015,Winter,11/29/2015,430 MONTANA 0 City of Louisville KY 40208,Structure Fire,111,111 - Building fire,0,1000,1000,30000,29000
33183,2015,Winter,11/30/2015,2301 7TH STREET n/a City of Louisville KY 40208,Structure Fire,111,111 - Building fire,0,20000,20000,34000,14000
33192,2015,Winter,11/30/2015,1700 NORRIS 110 City of Kingsley KY 40205,Structure Fire,118,"118 - Trash or rubbish fire, contained",5,0,5,0,-5
33238,2015,Winter,11/30/2015,4012 C CHURCHMAN n/a City of Louisville KY 40215,Structure Fire,111,111 - Building fire,15000,30000,45000,55780,10780
33403,2015,Winter,12/2/2015,1761 BELMAR n/a City of Audubon Park KY 40213,Structure Fire,111,111 - Building fire,1000,5000,6000,96300,90300
33454,2015,Winter,12/3/2015,1513 W MARKET N/A City of Louisville KY 40203,Structure Fire,111,111 - Building fire,500,1000,1500,1000,-500
33462,2015,Winter,12/3/2015,1125 S 8TH 17 City of Louisville KY 40203,Structure Fire,111,111 - Building fire,200,500,700,90000,89300
33551,2015,Winter,12/4/2015,3569 FINCASTLE N/A City of Audubon Park KY 40213,Structure Fire,111,111 - Building fire,500,10000,10500,339000,328500
33712,2015,Winter,12/5/2015,1814 W MARKET N/A City of Louisville KY 40203,Structure Fire,111,111 - Building fire,2000,15000,17000,34510,17510
33724,2015,Winter,12/6/2015,2922 CURRAN n/a City of Kingsley KY 40205,Structure Fire,111,111 - Building fire,8000,20000,28000,120000,92000
33740,2015,Winter,12/6/2015,2705 W JEFFERSON N/A City of Louisville KY 40212,Structure Fire,111,111 - Building fire,5000,30550,35550,30550,-5000
33795,2015,Winter,12/6/2015,1801 BASHFORD MANOR n/a City of Louisville KY 40218,Structure Fire,111,111 - Building fire,0,100,100,190000,189900
33837,2015,Winter,12/7/2015,3310 COLONIAL MANOR n/a City of Louisville KY 40218,Structure Fire,118,"118 - Trash or rubbish fire, contained",0,200,200,200,0
33851,2015,Winter,12/7/2015,GRINSTEAD City of Louisville KY 40204,Vehicle Fire,131,131 - Passenger vehicle fire,0,1000,1000,2000,1000
33887,2015,Winter,12/7/2015,512 ATWOOD n/a City of Louisville KY 40217,Structure Fire,118,"118 - Trash or rubbish fire, contained",0,500,500,75000,74500
33917,2015,Winter,12/7/2015,126 W GARRETT n/a City of Louisville KY 40214,Structure Fire,111,111 - Building fire,500,2500,3000,47000,44000
34011,2015,Winter,12/8/2015,7506 MERLYN n/a City of Louisville KY 40214,Structure Fire,111,111 - Building fire,3000,4000,7000,142000,135000
34113,2015,Winter,12/10/2015,2402 W CHESTNUT N/A City of Louisville KY 40211,Structure Fire,111,111 - Building fire,0,17570,17570,17570,0
34201,2015,Winter,12/10/2015,2318 W KENTUCKY na City of Louisville KY 40210,Structure Fire,111,111 - Building fire,15000,15000,30000,40000,10000
34113,2015,Winter,12/10/2015,2402 W CHESTNUT N/A City of Louisville KY 40211,Structure Fire,111,111 - Building fire,0,1000,1000,22950,21950
34237,2015,Winter,12/11/2015,633 E LIBERTY E9 City of Louisville KY 40202,Structure Fire,111,111 - Building fire,500,3000,3500,500000,496500
34250,2015,Winter,12/11/2015,2804 W CHESTNUT 2 City of Louisville KY 40211,Structure Fire,111,111 - Building fire,0,500,500,100000,99500
34313,2015,Winter,12/11/2015,1320 S FLOYD N/A City of Louisville KY 40208,Vehicle Fire,131,131 - Passenger vehicle fire,0,25000,25000,25000,0
34396,2015,Winter,12/12/2015,901 BLUEGRASS n/a City of Louisville KY 40215,Outside Fire,150,"150 - Outside rubbish fire, other",0,10,10,10,0
34423,2015,Winter,12/12/2015,TAYLOR City of Louisville KY 40215,Vehicle Fire,131,131 - Passenger vehicle fire,0,5000,5000,5000,0
34500,2015,Winter,12/13/2015,2119 GRIFFITHS n/a City of Louisville KY 40212,Structure Fire,118,"118 - Trash or rubbish fire, contained",0,50,50,24030,23980
34529,2015,Winter,12/14/2015,2325 OSAGE na City of Louisville KY 40210,Vehicle Fire,131,131 - Passenger vehicle fire,150,1800,1950,2600,650
34531,2015,Winter,12/14/2015,3001 MID DALE 3 City of Cambridge KY 40220,Structure Fire,112,112 - Fires in structure other than in a building,0,200,200,350000,349800
34563,2015,Winter,12/14/2015,1014 S 2ND 1710 City of Louisville KY 40203,Structure Fire,111,111 - Building fire,1000,100000,101000,100000,-1000
34583,2015,Winter,12/14/2015,846 RIVER CREST 38 City of Louisville KY 40206,Structure Fire,111,111 - Building fire,2000,2500,4500,2500,-2000
34612,2015,Winter,12/14/2015,2252 PAYNE N/A City of Louisville KY 40206,Structure Fire,111,111 - Building fire,1000,0,1000,156000,155000
34650,2015,Winter,12/15/2015,1301 BELMAR N/A City of Audubon Park KY 40213,Outside Fire,162,162 - Outside equipment fire,0,1000,1000,1000,0
34722,2015,Winter,12/15/2015,3738 GARLAND na City of Louisville KY 40211,Structure Fire,111,111 - Building fire,5000,15000,20000,39000,19000
34733,2015,Winter,12/16/2015,1920 W MUHAMMAD ALI N/A City of Louisville KY 40203,Structure Fire,111,111 - Building fire,10000,30150,40150,30150,-10000
34891,2015,Winter,12/17/2015,1425 S BROOK none City of Louisville KY 40208,Vehicle Fire,131,131 - Passenger vehicle fire,0,20000,20000,20000,0
34949,2015,Winter,12/18/2015,1987 BROWNSBORO Parking Lot City of Louisville KY 40206,Vehicle Fire,131,131 - Passenger vehicle fire,0,2500,2500,2500,0
34991,2015,Winter,12/19/2015,3530 W MARKET 304 City of Louisville KY 40212,Structure Fire,113,"113 - Cooking fire, confined to container",200,500,700,500,-200
35033,2015,Winter,12/19/2015,3235 DEL PARK na City of Louisville KY 40211,Structure Fire,111,111 - Building fire,5000,10000,15000,36710,21710
35143,2015,Winter,12/20/2015,1522 GALLAGHER N/A City of Louisville KY 40210,Structure Fire,111,111 - Building fire,15000,50000,65000,50000,-15000
35274,2015,Winter,12/22/2015,I 264 East City of Louisville KY 40218,Vehicle Fire,131,131 - Passenger vehicle fire,0,500,500,5000,4500
35276,2015,Winter,12/22/2015,4 COLLEGE n/a City of Louisville KY 40203,Vehicle Fire,131,131 - Passenger vehicle fire,0,8000,8000,8000,0
35339,2015,Winter,12/22/2015,1849 W HILL None City of Louisville KY 40210,Structure Fire,111,111 - Building fire,0,1000,1000,3000,2000
35340,2015,Winter,12/22/2015,3417 VIRGINIA 0 City of Louisville KY 40211,Structure Fire,111,111 - Building fire,0,500,500,500,0
35360,2015,Winter,12/23/2015,911 GRADE n/a City of Audubon Park KY 40213,Vehicle Fire,138,138 - Off-road vehicle or heavy equipment fire,0,2000,2000,20000,18000
35425,2015,Winter,12/23/2015,S 17TH City of Louisville KY 40210,Vehicle Fire,131,131 - Passenger vehicle fire,0,5000,5000,5000,0
35521,2015,Winter,12/24/2015,1300 SOUTHGATE n/a City of Louisville KY 40215,Structure Fire,112,112 - Fires in structure other than in a building,3000,0,3000,0,-3000
35526,2015,Winter,12/24/2015,3111 S 4TH n/a City of Louisville KY 40214,Vehicle Fire,131,131 - Passenger vehicle fire,0,3000,3000,5500,2500
35567,2015,Winter,12/24/2015,916 BURTON n/a City of Louisville KY 40208,Vehicle Fire,131,131 - Passenger vehicle fire,0,1850,1850,1850,0
35584,2015,Winter,12/24/2015,604 COMPTON n/a City of Louisville KY 40208,Structure Fire,111,111 - Building fire,5000,20000,25000,75000,50000
35808,2015,Winter,12/27/2015,227 CECIL N/A City of Louisville KY 40212,Structure Fire,113,"113 - Cooking fire, confined to container",700,0,700,0,-700
35994,2015,Winter,12/29/2015,530 S JACKSON N/A City of Louisville KY 40202,Vehicle Fire,131,131 - Passenger vehicle fire,0,3000,3000,3000,0
35995,2015,Winter,12/29/2015,448 S 10TH 448 City of Louisville KY 40203,Structure Fire,113,"113 - Cooking fire, confined to container",50,500,550,500,-50
36061,2015,Winter,12/30/2015,PALATKA City of Louisville KY 40214,Vehicle Fire,131,131 - Passenger vehicle fire,0,3000,3000,3000,0
36068,2015,Winter,12/30/2015,211 N 28TH NA City of Louisville KY 40212,Vehicle Fire,131,131 - Passenger vehicle fire,0,2275,2275,2275,0
36126,2015,Winter,12/31/2015,3203 VIRGINIA n/a City of Louisville KY 40211,Structure Fire,111,111 - Building fire,500,1000,1500,60000,58500
36145,2015,Winter,12/31/2015,I 64 West N/A City of Louisville KY 40212,Vehicle Fire,131,131 - Passenger vehicle fire,100,1000,1100,1000,-100
136,2016,Winter,1/2/2016,2016 DUNCAN N/A City of Louisville KY 40203,Structure Fire,111,111 - Building fire,0,17220,17220,22690,5470
144,2016,Winter,1/2/2016,707 S 3RD 912 City of Louisville KY 40202,Structure Fire,111,111 - Building fire,1000,1000,2000,5000000,4998000
202,2016,Winter,1/3/2016,4016 S 3RD N/A City of Louisville KY 40214,Structure Fire,111,111 - Building fire,12000,30000,42000,102750,60750
249,2016,Winter,1/3/2016,I 65 City of Audubon Park KY 40213,Outside Fire,150,"150 - Outside rubbish fire, other",400,0,400,0,-400
501,2016,Winter,1/6/2016,2900 DR WILLIAM G WEATHERS 131 (Mech. Roo) City of Louisville KY 40211,Structure Fire,116,"116 - Fuel burner/boiler malfunction, fire confined",0,5000,5000,3000000,2995000
603,2016,Winter,1/7/2016,600 CEDAR 0 City of Louisville KY 40202,Structure Fire,111,111 - Building fire,1000,1000,2000,1000,-1000
796,2016,Winter,1/8/2016,935 S JACKSON n/a City of Louisville KY 40203,Structure Fire,111,111 - Building fire,2000,10000,12000,85000,73000
924,2016,Winter,1/10/2016,106 FAIRFAX N/A City of Beechwood Village KY 40207,Structure Fire,111,111 - Building fire,100000,100000,200000,300000,100000
1099,2016,Winter,1/11/2016,338 GHEENS n/a City of Louisville KY 40214,Structure Fire,111,111 - Building fire,2000,10000,12000,10000,-2000
1101,2016,Winter,1/11/2016,1402 W MAIN N/A City of Louisville KY 40203,Structure Fire,111,111 - Building fire,0,500,500,500,0
1124,2016,Winter,1/11/2016,2510 NORTHWESTERN NA City of Louisville KY 40212,Structure Fire,112,112 - Fires in structure other than in a building,0,3500,3500,3500,0
1233,2016,Winter,1/12/2016,1054 PALATKA N/A City of Louisville KY 40214,Structure Fire,111,111 - Building fire,20000,80000,100000,136270,36270
1234,2016,Winter,1/12/2016,2521 W JEFFERSON N/A City of Louisville KY 40212,Structure Fire,111,111 - Building fire,20000,100000,120000,100000,-20000
1355,2016,Winter,1/14/2016,127 N 42ND N/A City of Louisville KY 40212,Structure Fire,111,111 - Building fire,10000,25000,35000,52970,17970
1440,2016,Winter,1/14/2016,1441 HICKORY n/a City of Louisville KY 40217,Structure Fire,111,111 - Building fire,5000,15000,20000,151000,131000
1440,2016,Winter,1/14/2016,1102 MILTON n/a City of Louisville KY 40217,Structure Fire,111,111 - Building fire,0,1000,1000,81500,80500
1445,2016,Winter,1/15/2016,461 S 13TH N/A City of Louisville KY 40203,Structure Fire,111,111 - Building fire,1000,1500,2500,5500,3000
1483,2016,Winter,1/15/2016,I 65 North n/a City of Louisville KY 40202,Vehicle Fire,131,131 - Passenger vehicle fire,200,2000,2200,4000,1800
1693,2016,Winter,1/17/2016,2827 W CHESTNUT N/A City of Louisville KY 40211,Structure Fire,111,111 - Building fire,0,500,500,31670,31170
1721,2016,Winter,1/17/2016,2906 S 5TH N/A City of Louisville KY 40208,Structure Fire,111,111 - Building fire,0,750,750,750,0
1746,2016,Winter,1/18/2016,I 264 West City of Louisville KY 40218,Vehicle Fire,131,131 - Passenger vehicle fire,0,2000,2000,3000,1000
1870,2016,Winter,1/19/2016,4110 TAYLOR N/a City of Louisville KY 40215,Structure Fire,111,111 - Building fire,500,0,500,NULL,NULL
1999,2016,Winter,1/20/2016,363 N 41ST N/A City of Louisville KY 40212,Structure Fire,113,"113 - Cooking fire, confined to container",500,0,500,0,-500
2146,2016,Winter,1/22/2016,614 S 28TH 0 City of Louisville KY 40211,Structure Fire,111,111 - Building fire,0,25000,25000,25000,0
2154,2016,Winter,1/22/2016,2614 GRAND na City of Louisville KY 40211,Structure Fire,111,111 - Building fire,1000,40000,41000,40000,-1000
2222,2016,Winter,1/22/2016,S CLAY City of Louisville KY 40203,Structure Fire,112,112 - Fires in structure other than in a building,100,0,100,0,-100
2228,2016,Winter,1/22/2016,2514 ST XAVIER ST LVIL na City of Louisville KY 40212,Structure Fire,111,111 - Building fire,0,12000,12000,42000,30000
2232,2016,Winter,1/22/2016,3705 MANSLICK N/A City of Louisville KY 40215,Structure Fire,111,111 - Building fire,10000,20000,30000,40000,10000
2313,2016,Winter,1/24/2016,4020 SHELBYVILLE N/A City of Beechwood Village KY 40207,Structure Fire,111,111 - Building fire,150,300,450,200000,199550
2446,2016,Winter,1/25/2016,W MADISON City of Louisville KY 40203,Vehicle Fire,131,131 - Passenger vehicle fire,0,1500,1500,3500,2000
2568,2016,Winter,1/26/2016,739 INVERNESS na City of Louisville KY 40214,Structure Fire,111,111 - Building fire,100,0,100,60000,59900
2615,2016,Winter,1/27/2016,621 N 25TH NA City of Louisville KY 40212,Structure Fire,113,"113 - Cooking fire, confined to container",500,0,500,NULL,NULL
2649,2016,Winter,1/27/2016,3145 TAYLOR none City of Louisville KY 40215,Structure Fire,111,111 - Building fire,15000,38696,53696,48373,-5323
2649,2016,Winter,1/27/2016,3145 TAYLOR none City of Louisville KY 40215,Structure Fire,111,111 - Building fire,0,5000,5000,5000,0
2649,2016,Winter,1/27/2016,3145 TAYLOR none City of Louisville KY 40215,Structure Fire,111,111 - Building fire,0,5000,5000,5000,0
2710,2016,Winter,1/28/2016,2650 ROWAN N/A City of Louisville KY 40212,Structure Fire,111,111 - Building fire,100,100,200,20000,19800
2733,2016,Winter,1/28/2016,CORNWALL City of Louisville KY 40212,Vehicle Fire,131,131 - Passenger vehicle fire,0,1000,1000,1000,0
2739,2016,Winter,1/28/2016,S 6TH City of Louisville KY 40202,Vehicle Fire,131,131 - Passenger vehicle fire,300,8500,8800,8500,-300
2739,2016,Winter,1/28/2016,S 6TH City of Louisville KY 40202,Vehicle Fire,131,131 - Passenger vehicle fire,0,2000,2000,4000,2000
2992,2016,Winter,1/30/2016,500BLK E ST CATHERINE N/A City of Louisville KY 40203,Outside Fire,160,"160 - Special outside fire, other",0,5000,5000,8000,3000
2943,2016,Winter,1/30/2016,3219 GOLDEN TURTLE 102 City of Louisville KY 40218,Structure Fire,111,111 - Building fire,0,200,200,200,0
3087,2016,Winter,1/31/2016,3221 POPLAR LEVEL Kitchen City of Audubon Park KY 40213,Structure Fire,113,"113 - Cooking fire, confined to container",0,500,500,500,0
3352,2016,Spring,2/3/2016,901 ESQUIRE apt City of Louisville KY 40203,Structure Fire,112,112 - Fires in structure other than in a building,800,500,1300,500,-800
3415,2016,Spring,2/3/2016,301 N 26TH n/a City of Louisville KY 40212,Structure Fire,111,111 - Building fire,0,7000,7000,50000,43000
3556,2016,Spring,2/5/2016,945 S FLOYD N/A City of Louisville KY 40203,Vehicle Fire,131,131 - Passenger vehicle fire,400,12000,12400,25000,12600
3695,2016,Spring,2/7/2016,1935 S 30TH n/a City of Louisville KY 40210,Structure Fire,111,111 - Building fire,5000,20000,25000,35000,10000
3711,2016,Spring,2/7/2016,6607 EVANGELINE n/a City of Louisville KY 40214,Structure Fire,111,111 - Building fire,5000,25000,30000,50000,20000
3756,2016,Spring,2/7/2016,211 N 32ND N/A City of Louisville KY 40212,Vehicle Fire,131,131 - Passenger vehicle fire,0,800,800,800,0
3773,2016,Spring,2/7/2016,GRINSTEAD City of Louisville KY 40204,Vehicle Fire,132,132 - Road freight or transport vehicle fire,0,300,300,50000,49700
3799,2016,Spring,2/8/2016,S 2ND City of Louisville KY 40202,Vehicle Fire,131,131 - Passenger vehicle fire,0,3000,3000,3000,0
3840,2016,Spring,2/8/2016,2625 PORTLAND N/A City of Louisville KY 40212,Structure Fire,111,111 - Building fire,0,2000,2000,2000,0
3907,2016,Spring,2/9/2016,2202 MAPLE NA City of Louisville KY 40211,Structure Fire,111,111 - Building fire,0,1000,1000,20060,19060
4042,2016,Spring,2/10/2016,1807 COMMERCE N/A City of Louisville KY 40208,Structure Fire,111,111 - Building fire,10000,2000,12000,400000,388000
4045,2016,Spring,2/11/2016,1520 BLUEGRASS n/a City of Louisville KY 40215,Structure Fire,111,111 - Building fire,500,2500,3000,61400,58400
4081,2016,Spring,2/11/2016,3015 WILSON n/a City of Louisville KY 40211,Vehicle Fire,132,132 - Road freight or transport vehicle fire,0,230000,230000,230000,0
4083,2016,Spring,2/11/2016,1518 OLEANDA 1 City of Louisville KY 40215,Structure Fire,113,"113 - Cooking fire, confined to container",10,200,210,65000,64790
4144,2016,Spring,2/11/2016,422 HEYWOOD 220 City of Louisville KY 40208,Structure Fire,113,"113 - Cooking fire, confined to container",0,100,100,100,0
4331,2016,Spring,2/13/2016,4149 TAYLOR n/a City of Louisville KY 40215,Vehicle Fire,131,131 - Passenger vehicle fire,0,2000,2000,2000,0
4511,2016,Spring,2/15/2016,222 E ORMSBY 2 City of Louisville KY 40203,Structure Fire,111,111 - Building fire,0,250,250,250,0
4534,2016,Spring,2/16/2016,2300 BROWNSBORO N/A City of Louisville KY 40206,Vehicle Fire,131,131 - Passenger vehicle fire,0,1500,1500,3500,2000
4620,2016,Spring,2/17/2016,1826 W MAIN N/A City of Louisville KY 40203,Structure Fire,111,111 - Building fire,10000,20000,30000,25580,-4420
4625,2016,Spring,2/17/2016,667 SOUTHWESTERN N/A City of Louisville KY 40211,Structure Fire,111,111 - Building fire,5000,30000,35000,104220,69220
4688,2016,Spring,2/17/2016,3515 GRANDVIEW n/a City of Beechwood Village KY 40207,Structure Fire,111,111 - Building fire,10,500,510,5000000,4999490
4698,2016,Spring,2/17/2016,1817 WENATCHEE 0 City of Louisville KY 40210,Vehicle Fire,131,131 - Passenger vehicle fire,0,35000,35000,35000,0
4827,2016,Spring,2/19/2016,2801 BARDSTOWN n/a City of Kingsley KY 40205,Vehicle Fire,131,131 - Passenger vehicle fire,0,4000,4000,4000,0
4832,2016,Spring,2/19/2016,2978 WILSON 200 City of Louisville KY 40211,Structure Fire,113,"113 - Cooking fire, confined to container",2000,5000,7000,5000,-2000
4876,2016,Spring,2/19/2016,1506 BERRY na City of Louisville KY 40215,Vehicle Fire,131,131 - Passenger vehicle fire,0,6000,6000,12000,6000
4877,2016,Spring,2/19/2016,N 31ST City of Louisville KY 40212,Vehicle Fire,131,131 - Passenger vehicle fire,0,1000,1000,1000,0
4891,2016,Spring,2/19/2016,2140 BONNYCASTLE N/A City of Kingsley KY 40205,Structure Fire,118,"118 - Trash or rubbish fire, contained",20,0,20,0,-20
4940,2016,Spring,2/20/2016,519 W WOODLAWN n/a City of Louisville KY 40214,Vehicle Fire,131,131 - Passenger vehicle fire,0,3000,3000,5000,2000
4964,2016,Spring,2/20/2016,2710 NARRAGANSETT n/a City of Louisville KY 40210,Structure Fire,113,"113 - Cooking fire, confined to container",0,200,200,40000,39800
5115,2016,Spring,2/21/2016,454 E BRANDEIS none City of Louisville KY 40217,Structure Fire,111,111 - Building fire,0,5000,5000,5000,0
5121,2016,Spring,2/21/2016,1505 THACKERAY n/a City of Kingsley KY 40205,Structure Fire,111,111 - Building fire,15000,40000,55000,225000,170000
5174,2016,Spring,2/22/2016,308 MEADOWOOD 3 City of Louisville KY 40214,Structure Fire,111,111 - Building fire,5000,30000,35000,140400,105400
5182,2016,Spring,2/22/2016,1312 S PRESTON N/A City of Louisville KY 40208,Structure Fire,111,111 - Building fire,5000,41630,46630,41630,-5000
5182,2016,Spring,2/22/2016,1314 S PRESTON N/A City of Louisville KY 40208,Structure Fire,111,111 - Building fire,0,30000,30000,57110,27110
5321,2016,Spring,2/23/2016,1516 S 12TH 1 City of Louisville KY 40210,Vehicle Fire,131,131 - Passenger vehicle fire,0,10000,10000,10000,0
5343,2016,Spring,2/24/2016,735 S 38TH na City of Louisville KY 40211,Vehicle Fire,131,131 - Passenger vehicle fire,0,3000,3000,3000,0
5345,2016,Spring,2/24/2016,W BROADWAY City of Louisville KY 40202,Structure Fire,111,111 - Building fire,49,50,99,2500,2401
5361,2016,Spring,2/24/2016,110 W MAIN parking lot City of Louisville KY 40202,Vehicle Fire,131,131 - Passenger vehicle fire,0,2800,2800,2800,0
5517,2016,Spring,2/26/2016,717 W OAK 103 City of Louisville KY 40203,Structure Fire,111,111 - Building fire,360,0,360,150000,149640
5743,2016,Spring,2/28/2016,I 264 City of Louisville KY 40209,Vehicle Fire,130,"130 - Mobile property (vehicle) fire, other",1400,1500,2900,1500,-1400
5775,2016,Spring,2/28/2016,2730 S 4TH 4 City of Louisville KY 40208,Structure Fire,111,111 - Building fire,500,800,1300,41000,39700
5783,2016,Spring,2/28/2016,723 E KENTUCKY N/A City of Louisville KY 40203,Structure Fire,111,111 - Building fire,1500,8000,9500,33080,23580
5786,2016,Spring,2/28/2016,425 N 28TH n/a City of Louisville KY 40212,Structure Fire,111,111 - Building fire,0,5000,5000,15020,10020
5783,2016,Spring,2/28/2016,725 E KENTUCKY N/A City of Louisville KY 40203,Structure Fire,111,111 - Building fire,0,4000,4000,52330,48330
5786,2016,Spring,2/28/2016,423 N 28TH n/a City of Louisville KY 40212,Structure Fire,111,111 - Building fire,0,1000,1000,20230,19230
5883,2016,Spring,2/29/2016,3022 CARSON n/a City of Kingsley KY 40205,Vehicle Fire,131,131 - Passenger vehicle fire,400,4500,4900,6000,1100
5883,2016,Spring,2/29/2016,3022 CARSON n/a City of Kingsley KY 40205,Vehicle Fire,131,131 - Passenger vehicle fire,0,1500,1500,8000,6500
5941,2016,Spring,3/1/2016,263 DELMONT n/a City of Louisville KY 40206,Structure Fire,111,111 - Building fire,500,1000,1500,90000,88500
5957,2016,Spring,3/1/2016,3469 GLENDALE na City of Louisville KY 40215,Vehicle Fire,131,131 - Passenger vehicle fire,200,8000,8200,8000,-200
5984,2016,Spring,3/1/2016,743 DEARBORN N/A City of Louisville KY 40211,Structure Fire,111,111 - Building fire,7000,25000,32000,63000,31000
5957,2016,Spring,3/1/2016,3469 GLENDALE na City of Louisville KY 40215,Vehicle Fire,131,131 - Passenger vehicle fire,0,500,500,80000,79500
6196,2016,Spring,3/3/2016,1025 CARLISLE n/a City of Louisville KY 40215,Vehicle Fire,132,132 - Road freight or transport vehicle fire,2000,18000,20000,18000,-2000
6278,2016,Spring,3/4/2016,S 12TH City of Louisville KY 40210,Vehicle Fire,131,131 - Passenger vehicle fire,0,2000,2000,3000,1000
6307,2016,Spring,3/5/2016,819 S 33RD na City of Louisville KY 40211,Vehicle Fire,131,131 - Passenger vehicle fire,0,15000,15000,15000,0
6362,2016,Spring,3/5/2016,3113 PORTLAND NA City of Louisville KY 40212,Structure Fire,111,111 - Building fire,0,5000,5000,60000,55000
6381,2016,Spring,3/5/2016,1118 CARLISLE n/a City of Louisville KY 40215,Structure Fire,111,111 - Building fire,500,5000,5500,5000,-500
6391,2016,Spring,3/5/2016,2510 COLUMBIA NA City of Louisville KY 40212,Structure Fire,111,111 - Building fire,0,10000,10000,20000,10000
6416,2016,Spring,3/6/2016,1148 S 17TH 2 City of Louisville KY 40210,Structure Fire,111,111 - Building fire,0,2500,2500,10000,7500
6486,2016,Spring,3/6/2016,I 65 South n/a City of Louisville KY 40217,Vehicle Fire,131,131 - Passenger vehicle fire,0,600,600,600,0
6490,2016,Spring,3/6/2016,1177 CASTLEVALE n/a City of Louisville KY 40217,Vehicle Fire,131,131 - Passenger vehicle fire,0,2000,2000,2000,0
6532,2016,Spring,3/6/2016,2429 MAPLE 0 City of Louisville KY 40211,Vehicle Fire,131,131 - Passenger vehicle fire,0,7000,7000,7000,0
6603,2016,Spring,3/7/2016,436 DAVIES n/a City of Louisville KY 40208,Structure Fire,111,111 - Building fire,2000,5000,7000,400000,393000
6708,2016,Spring,3/8/2016,2925 ENGLISH 3rd Floor Apt. City of Louisville KY 40206,Structure Fire,111,111 - Building fire,30000,50000,80000,50000,-30000
7270,2016,Spring,3/13/2016,S 3RD City of Louisville KY 40203,Vehicle Fire,131,131 - Passenger vehicle fire,0,5000,5000,5000,0
7303,2016,Spring,3/14/2016,834 E CHESTNUT Rear alley City of Louisville KY 40204,Vehicle Fire,131,131 - Passenger vehicle fire,100,5000,5100,5000,-100
7304,2016,Spring,3/14/2016,1505 ARLING n/a City of Louisville KY 40215,Structure Fire,111,111 - Building fire,1000,10000,11000,46920,35920
7583,2016,Spring,3/16/2016,700 W BROADWAY na City of Louisville KY 40202,Vehicle Fire,131,131 - Passenger vehicle fire,300,1500,1800,1500,-300
7665,2016,Spring,3/17/2016,1016 W ASHLAND n/a City of Louisville KY 40215,Vehicle Fire,131,131 - Passenger vehicle fire,0,50,50,5000,4950
7729,2016,Spring,3/18/2016,3525 RUDD N/A City of Louisville KY 40212,Vehicle Fire,131,131 - Passenger vehicle fire,0,15000,15000,15000,0
7769,2016,Spring,3/18/2016,I 264 City of Louisville KY 40212,Vehicle Fire,137,137 - Camper or recreational vehicle (RV) fire,0,500,500,5000,4500
7795,2016,Spring,3/18/2016,1001 S 32ND n/a City of Louisville KY 40211,Structure Fire,111,111 - Building fire,0,10000,10000,22430,12430
7936,2016,Spring,3/19/2016,S PRESTON City of Louisville KY 40202,Structure Fire,112,112 - Fires in structure other than in a building,100,0,100,0,-100
7947,2016,Spring,3/20/2016,1440 S 6TH n/a City of Louisville KY 40208,Structure Fire,111,111 - Building fire,30000,50000,80000,121000,41000
8080,2016,Spring,3/21/2016,2807 HIKES N/A City of Louisville KY 40218,Structure Fire,111,111 - Building fire,0,18000,18000,118000,100000
8083,2016,Spring,3/21/2016,1633 SALE na City of Louisville KY 40215,Structure Fire,111,111 - Building fire,80000,20000,100000,20000,-80000
8168,2016,Spring,3/22/2016,4202 WISTERIA LANDING N/A City of Louisville KY 40218,Structure Fire,111,111 - Building fire,75000,250000,325000,1250000,925000
8185,2016,Spring,3/22/2016,2819 ELEANOR n/a City of Kingsley KY 40205,Structure Fire,111,111 - Building fire,200,2000,2200,180000,177800
8213,2016,Spring,3/22/2016,1007 BARDSTOWN None City of Louisville KY 40204,Structure Fire,111,111 - Building fire,0,5000,5000,400000,395000
8222,2016,Spring,3/22/2016,2542 ST CECILIA na City of Louisville KY 40212,Vehicle Fire,131,131 - Passenger vehicle fire,0,2000,2000,4000,2000
8296,2016,Spring,3/23/2016,2810 W MARKET N/A City of Louisville KY 40212,Structure Fire,111,111 - Building fire,400,1000,1400,10000,8600
8332,2016,Spring,3/24/2016,624 S 36TH N/A City of Louisville KY 40211,Vehicle Fire,131,131 - Passenger vehicle fire,0,10000,10000,10000,0
8335,2016,Spring,3/24/2016,4332 S 1ST n/a City of Louisville KY 40214,Structure Fire,112,112 - Fires in structure other than in a building,0,50,50,60000,59950
8372,2016,Spring,3/24/2016,104 E TENNY 1 City of Louisville KY 40214,Structure Fire,111,111 - Building fire,0,500,500,60000,59500
8375,2016,Spring,3/24/2016,1951 BISHOP 101 City of Louisville KY 40218,Outside Fire,142,142 - Brush or brush-and-grass mixture fire,0,500,500,4200000,4199500
8711,2016,Spring,3/27/2016,200 E CHESTNUT n/a City of Louisville KY 40202,Vehicle Fire,131,131 - Passenger vehicle fire,100,2000,2100,2000,-100
8729,2016,Spring,3/27/2016,1712 W CHESTNUT na City of Louisville KY 40203,Structure Fire,111,111 - Building fire,0,1000,1000,1000,0
8694,2016,Spring,3/27/2016,1830 W HILL n/a City of Louisville KY 40210,Structure Fire,111,111 - Building fire,1500,1500,3000,70000,67000
8945,2016,Spring,3/30/2016,3840 SOUTHERN n/a City of Louisville KY 40214,Vehicle Fire,131,131 - Passenger vehicle fire,0,2000,2000,2000,0
8945,2016,Spring,3/30/2016,3840 SOUTHERN n/a City of Louisville KY 40214,Vehicle Fire,131,131 - Passenger vehicle fire,150,500,650,2000,1350
9108,2016,Spring,3/31/2016,E BROADWAY City of Louisville KY 40204,Vehicle Fire,131,131 - Passenger vehicle fire,100,6000,6100,6000,-100
9227,2016,Spring,4/1/2016,4703 S RUTLAND n/a City of Louisville KY 40215,Structure Fire,111,111 - Building fire,400,0,400,0,-400
9227,2016,Spring,4/1/2016,4703 S RUTLAND n/a City of Louisville KY 40215,Structure Fire,111,111 - Building fire,400,0,400,0,-400
9227,2016,Spring,4/1/2016,4703 S RUTLAND n/a City of Louisville KY 40215,Structure Fire,111,111 - Building fire,400,0,400,0,-400
9249,2016,Spring,4/2/2016,1505 W Market 0 City of Louisville KY 40203,Structure Fire,111,111 - Building fire,0,63000,63000,63000,0
9276,2016,Spring,4/2/2016,118 BOSTON n/a City of Louisville KY 40212,Structure Fire,111,111 - Building fire,200,0,200,0,-200
9350,2016,Spring,4/2/2016,413 E MUHAMMAD ALI 1209 City of Louisville KY 40202,Structure Fire,111,111 - Building fire,0,2000,2000,1200000,1198000
9249,2016,Spring,4/2/2016,1505 W Market 0 City of Louisville KY 40203,Structure Fire,111,111 - Building fire,0,63000,63000,63000,0
9276,2016,Spring,4/2/2016,118 BOSTON n/a City of Louisville KY 40212,Structure Fire,111,111 - Building fire,200,0,200,0,-200
9350,2016,Spring,4/2/2016,413 E MUHAMMAD ALI 1209 City of Louisville KY 40202,Structure Fire,111,111 - Building fire,0,2000,2000,1200000,1198000
9249,2016,Spring,4/2/2016,1505 W Market 0 City of Louisville KY 40203,Structure Fire,111,111 - Building fire,0,63000,63000,63000,0
9276,2016,Spring,4/2/2016,118 BOSTON n/a City of Louisville KY 40212,Structure Fire,111,111 - Building fire,200,0,200,0,-200
9350,2016,Spring,4/2/2016,413 E MUHAMMAD ALI 1209 City of Louisville KY 40202,Structure Fire,111,111 - Building fire,0,2000,2000,1200000,1198000
9427,2016,Spring,4/3/2016,2915 ROWAN n/a City of Louisville KY 40212,Structure Fire,111,111 - Building fire,0,1000,1000,38000,37000
9451,2016,Spring,4/3/2016,120 N 18TH NA City of Louisville KY 40203,Structure Fire,111,111 - Building fire,3000,12000,15000,24800,9800
9461,2016,Spring,4/3/2016,2130 W BROADWAY n/a City of Louisville KY 40211,Structure Fire,112,112 - Fires in structure other than in a building,0,1200,1200,80000,78800
9427,2016,Spring,4/3/2016,2915 ROWAN n/a City of Louisville KY 40212,Structure Fire,111,111 - Building fire,0,1000,1000,38000,37000
9451,2016,Spring,4/3/2016,120 N 18TH NA City of Louisville KY 40203,Structure Fire,111,111 - Building fire,3000,12000,15000,24800,9800
9461,2016,Spring,4/3/2016,2130 W BROADWAY n/a City of Louisville KY 40211,Structure Fire,112,112 - Fires in structure other than in a building,0,1200,1200,80000,78800
9427,2016,Spring,4/3/2016,2915 ROWAN n/a City of Louisville KY 40212,Structure Fire,111,111 - Building fire,0,1000,1000,38000,37000
9451,2016,Spring,4/3/2016,120 N 18TH NA City of Louisville KY 40203,Structure Fire,111,111 - Building fire,3000,12000,15000,24800,9800
9461,2016,Spring,4/3/2016,2130 W BROADWAY n/a City of Louisville KY 40211,Structure Fire,112,112 - Fires in structure other than in a building,0,1200,1200,80000,78800
9467,2016,Spring,4/4/2016,2330 CRITTENDEN 220 City of Louisville KY 40217,Vehicle Fire,131,131 - Passenger vehicle fire,50,1200,1250,1200,-50
9487,2016,Spring,4/4/2016,3825 W MARKET N/A City of Louisville KY 40212,Structure Fire,111,111 - Building fire,0,100,100,86820,86720
9506,2016,Spring,4/4/2016,5019 WABASH na City of Louisville KY 40214,Vehicle Fire,131,131 - Passenger vehicle fire,0,1000,1000,1000,0
9555,2016,Spring,4/4/2016,3020 W KENTUCKY N/A City of Louisville KY 40211,Structure Fire,111,111 - Building fire,500,1500,2000,21370,19370
9556,2016,Spring,4/4/2016,3616 MANSLICK A City of Louisville KY 40215,Structure Fire,111,111 - Building fire,500,500,1000,214000,213000
9563,2016,Spring,4/4/2016,1529 BARDSTOWN N/A City of Kingsley KY 40205,Vehicle Fire,131,131 - Passenger vehicle fire,0,1500,1500,1500,0
9555,2016,Spring,4/4/2016,3020 W KENTUCKY N/A City of Louisville KY 40211,Structure Fire,111,111 - Building fire,500,1500,2000,21370,19370
9556,2016,Spring,4/4/2016,3616 MANSLICK A City of Louisville KY 40215,Structure Fire,111,111 - Building fire,500,500,1000,214000,213000
9563,2016,Spring,4/4/2016,1529 BARDSTOWN N/A City of Kingsley KY 40205,Vehicle Fire,131,131 - Passenger vehicle fire,0,1500,1500,1500,0
9467,2016,Spring,4/4/2016,2330 CRITTENDEN 220 City of Louisville KY 40217,Vehicle Fire,131,131 - Passenger vehicle fire,50,1200,1250,1200,-50
9487,2016,Spring,4/4/2016,3825 W MARKET N/A City of Louisville KY 40212,Structure Fire,111,111 - Building fire,0,100,100,86820,86720
9506,2016,Spring,4/4/2016,5019 WABASH na City of Louisville KY 40214,Vehicle Fire,131,131 - Passenger vehicle fire,0,1000,1000,1000,0
9555,2016,Spring,4/4/2016,3020 W KENTUCKY N/A City of Louisville KY 40211,Structure Fire,111,111 - Building fire,500,1500,2000,21370,19370
9556,2016,Spring,4/4/2016,3616 MANSLICK A City of Louisville KY 40215,Structure Fire,111,111 - Building fire,500,500,1000,214000,213000
9563,2016,Spring,4/4/2016,1529 BARDSTOWN N/A City of Kingsley KY 40205,Vehicle Fire,131,131 - Passenger vehicle fire,0,1500,1500,1500,0
9467,2016,Spring,4/4/2016,2330 CRITTENDEN 220 City of Louisville KY 40217,Vehicle Fire,131,131 - Passenger vehicle fire,50,1200,1250,1200,-50
9487,2016,Spring,4/4/2016,3825 W MARKET N/A City of Louisville KY 40212,Structure Fire,111,111 - Building fire,0,100,100,86820,86720
9506,2016,Spring,4/4/2016,5019 WABASH na City of Louisville KY 40214,Vehicle Fire,131,131 - Passenger vehicle fire,0,1000,1000,1000,0
9573,2016,Spring,4/5/2016,2810 W MARKET NA City of Louisville KY 40212,Structure Fire,111,111 - Building fire,1000,5000,6000,39620,33620
9573,2016,Spring,4/5/2016,2810 W MARKET NA City of Louisville KY 40212,Structure Fire,111,111 - Building fire,0,800,800,24470,23670
9618,2016,Spring,4/5/2016,3006 MELBOURNE n/a City of Cambridge KY 40220,Vehicle Fire,131,131 - Passenger vehicle fire,500,500,1000,9000,8000
9618,2016,Spring,4/5/2016,3006 MELBOURNE n/a City of Cambridge KY 40220,Vehicle Fire,131,131 - Passenger vehicle fire,500,500,1000,9000,8000
9573,2016,Spring,4/5/2016,2810 W MARKET NA City of Louisville KY 40212,Structure Fire,111,111 - Building fire,1000,5000,6000,39620,33620
9618,2016,Spring,4/5/2016,3006 MELBOURNE n/a City of Cambridge KY 40220,Vehicle Fire,131,131 - Passenger vehicle fire,500,500,1000,9000,8000
9573,2016,Spring,4/5/2016,2810 W MARKET NA City of Louisville KY 40212,Structure Fire,111,111 - Building fire,0,800,800,24470,23670
9573,2016,Spring,4/5/2016,2810 W MARKET NA City of Louisville KY 40212,Structure Fire,111,111 - Building fire,1000,5000,6000,39620,33620
9573,2016,Spring,4/5/2016,2810 W MARKET NA City of Louisville KY 40212,Structure Fire,111,111 - Building fire,0,800,800,24470,23670
9655,2016,Spring,4/6/2016,1144 S 28TH na City of Louisville KY 40211,Structure Fire,111,111 - Building fire,20000,34350,54350,34350,-20000
9655,2016,Spring,4/6/2016,1144 S 28TH na City of Louisville KY 40211,Structure Fire,111,111 - Building fire,20000,34350,54350,34350,-20000
9655,2016,Spring,4/6/2016,1144 S 28TH na City of Louisville KY 40211,Structure Fire,111,111 - Building fire,20000,34350,54350,34350,-20000
9826,2016,Spring,4/7/2016,3614 WHEELER n/a City of Louisville KY 40215,Structure Fire,111,111 - Building fire,4000,20000,24000,53590,29590
9826,2016,Spring,4/7/2016,3614 WHEELER n/a City of Louisville KY 40215,Structure Fire,111,111 - Building fire,4000,20000,24000,53590,29590
9826,2016,Spring,4/7/2016,3614 WHEELER n/a City of Louisville KY 40215,Structure Fire,111,111 - Building fire,4000,20000,24000,53590,29590
9867,2016,Spring,4/8/2016,1137 SCHILLER 22 City of Louisville KY 40204,Structure Fire,111,111 - Building fire,2000,4000,6000,541000,535000
9887,2016,Spring,4/8/2016,248 THOMPSON N/A City of Louisville KY 40206,Structure Fire,111,111 - Building fire,0,2000,2000,100000,98000
9867,2016,Spring,4/8/2016,1137 SCHILLER 22 City of Louisville KY 40204,Structure Fire,111,111 - Building fire,2000,4000,6000,541000,535000
9887,2016,Spring,4/8/2016,248 THOMPSON N/A City of Louisville KY 40206,Structure Fire,111,111 - Building fire,0,2000,2000,100000,98000
9867,2016,Spring,4/8/2016,1137 SCHILLER 22 City of Louisville KY 40204,Structure Fire,111,111 - Building fire,2000,4000,6000,541000,535000
9887,2016,Spring,4/8/2016,248 THOMPSON N/A City of Louisville KY 40206,Structure Fire,111,111 - Building fire,0,2000,2000,100000,98000
10115,2016,Spring,4/10/2016,1826 W KENTUCKY n/a City of Louisville KY 40210,Structure Fire,113,"113 - Cooking fire, confined to container",100,0,100,NULL,NULL
10116,2016,Spring,4/10/2016,3311 KIRBY N/A City of Louisville KY 40211,Structure Fire,111,111 - Building fire,10000,20500,30500,20500,-10000
10115,2016,Spring,4/10/2016,1826 W KENTUCKY n/a City of Louisville KY 40210,Structure Fire,113,"113 - Cooking fire, confined to container",100,0,100,NULL,NULL
10116,2016,Spring,4/10/2016,3311 KIRBY N/A City of Louisville KY 40211,Structure Fire,111,111 - Building fire,10000,20500,30500,20500,-10000
10115,2016,Spring,4/10/2016,1826 W KENTUCKY n/a City of Louisville KY 40210,Structure Fire,113,"113 - Cooking fire, confined to container",100,0,100,NULL,NULL
10116,2016,Spring,4/10/2016,3311 KIRBY N/A City of Louisville KY 40211,Structure Fire,111,111 - Building fire,10000,20500,30500,20500,-10000
10138,2016,Spring,4/11/2016,I 65 City of Audubon Park KY 40213,Vehicle Fire,131,131 - Passenger vehicle fire,0,3000,3000,3000,0
10138,2016,Spring,4/11/2016,I 65 City of Audubon Park KY 40213,Vehicle Fire,131,131 - Passenger vehicle fire,0,3000,3000,3000,0
10138,2016,Spring,4/11/2016,I 65 City of Audubon Park KY 40213,Vehicle Fire,131,131 - Passenger vehicle fire,0,3000,3000,3000,0
10235,2016,Spring,4/12/2016,173 FRANCIS N/A City of Louisville KY 40214,Structure Fire,111,111 - Building fire,5000,10000,15000,10000,-5000
10235,2016,Spring,4/12/2016,173 FRANCIS N/A City of Louisville KY 40214,Structure Fire,111,111 - Building fire,5000,10000,15000,10000,-5000
10235,2016,Spring,4/12/2016,173 FRANCIS N/A City of Louisville KY 40214,Structure Fire,111,111 - Building fire,5000,10000,15000,10000,-5000
10423,2016,Spring,4/14/2016,2223 GRIFFITHS NA City of Louisville KY 40212,Vehicle Fire,131,131 - Passenger vehicle fire,0,3000,3000,7500,4500
10497,2016,Spring,4/14/2016,2702 TAYLOR Kitchen City of Louisville KY 40208,Structure Fire,111,111 - Building fire,5000,25000,30000,47000,17000
10423,2016,Spring,4/14/2016,2223 GRIFFITHS NA City of Louisville KY 40212,Vehicle Fire,131,131 - Passenger vehicle fire,0,3000,3000,7500,4500
10497,2016,Spring,4/14/2016,2702 TAYLOR Kitchen City of Louisville KY 40208,Structure Fire,111,111 - Building fire,5000,25000,30000,47000,17000
10423,2016,Spring,4/14/2016,2223 GRIFFITHS NA City of Louisville KY 40212,Vehicle Fire,131,131 - Passenger vehicle fire,0,3000,3000,7500,4500
10497,2016,Spring,4/14/2016,2702 TAYLOR Kitchen City of Louisville KY 40208,Structure Fire,111,111 - Building fire,5000,25000,30000,47000,17000
10622,2016,Spring,4/16/2016,511 S 5TH apt City of Louisville KY 40202,Structure Fire,111,111 - Building fire,2000,5000,7000,5000,-2000
10680,2016,Spring,4/16/2016,2335 HOWARD na City of Louisville KY 40211,Structure Fire,111,111 - Building fire,2000,7000,9000,22000,13000
10622,2016,Spring,4/16/2016,511 S 5TH apt City of Louisville KY 40202,Structure Fire,111,111 - Building fire,2000,5000,7000,5000,-2000
10680,2016,Spring,4/16/2016,2335 HOWARD na City of Louisville KY 40211,Structure Fire,111,111 - Building fire,2000,7000,9000,22000,13000
10622,2016,Spring,4/16/2016,511 S 5TH apt City of Louisville KY 40202,Structure Fire,111,111 - Building fire,2000,5000,7000,5000,-2000
10680,2016,Spring,4/16/2016,2335 HOWARD na City of Louisville KY 40211,Structure Fire,111,111 - Building fire,2000,7000,9000,22000,13000
10769,2016,Spring,4/17/2016,1818 W GAULBERT NA City of Louisville KY 40210,Structure Fire,111,111 - Building fire,1500,10000,11500,10000,-1500
10777,2016,Spring,4/17/2016,1704 BARDSTOWN B City of Kingsley KY 40205,Outside Fire,160,"160 - Special outside fire, other",0,100,100,100,0
10769,2016,Spring,4/17/2016,1818 W GAULBERT NA City of Louisville KY 40210,Structure Fire,111,111 - Building fire,1500,10000,11500,10000,-1500
10777,2016,Spring,4/17/2016,1704 BARDSTOWN B City of Kingsley KY 40205,Outside Fire,160,"160 - Special outside fire, other",0,100,100,100,0
10769,2016,Spring,4/17/2016,1818 W GAULBERT NA City of Louisville KY 40210,Structure Fire,111,111 - Building fire,1500,10000,11500,10000,-1500
10777,2016,Spring,4/17/2016,1704 BARDSTOWN B City of Kingsley KY 40205,Outside Fire,160,"160 - Special outside fire, other",0,100,100,100,0
10969,2016,Spring,4/19/2016,RIVER PARK City of Louisville KY 40211,Vehicle Fire,131,131 - Passenger vehicle fire,0,5000,5000,15000,10000
10969,2016,Spring,4/19/2016,RIVER PARK City of Louisville KY 40211,Vehicle Fire,131,131 - Passenger vehicle fire,0,5000,5000,15000,10000
10969,2016,Spring,4/19/2016,RIVER PARK City of Louisville KY 40211,Vehicle Fire,131,131 - Passenger vehicle fire,0,5000,5000,15000,10000
11120,2016,Spring,4/20/2016,S 42ND City of Louisville KY 40211,Structure Fire,111,111 - Building fire,1000,1000,2000,1000,-1000
11188,2016,Spring,4/20/2016,1423 W ORMSBY n/a City of Louisville KY 40210,Structure Fire,123,"123 - Fire in portable building, fixed location",0,50,50,50,0
11120,2016,Spring,4/20/2016,S 42ND City of Louisville KY 40211,Structure Fire,111,111 - Building fire,1000,1000,2000,1000,-1000
11120,2016,Spring,4/20/2016,S 42ND City of Louisville KY 40211,Structure Fire,111,111 - Building fire,1000,1000,2000,1000,-1000
11188,2016,Spring,4/20/2016,1423 W ORMSBY n/a City of Louisville KY 40210,Structure Fire,123,"123 - Fire in portable building, fixed location",0,50,50,50,0
11188,2016,Spring,4/20/2016,1423 W ORMSBY n/a City of Louisville KY 40210,Structure Fire,123,"123 - Fire in portable building, fixed location",0,50,50,50,0
11648,2016,Spring,4/25/2016,I 71 South City of Beechwood Village KY 40207,Vehicle Fire,131,131 - Passenger vehicle fire,500,8000,8500,8000,-500
11648,2016,Spring,4/25/2016,I 71 South City of Beechwood Village KY 40207,Vehicle Fire,131,131 - Passenger vehicle fire,500,8000,8500,8000,-500
11648,2016,Spring,4/25/2016,I 71 South City of Beechwood Village KY 40207,Vehicle Fire,131,131 - Passenger vehicle fire,500,8000,8500,8000,-500
11771,2016,Spring,4/26/2016,729 S 39TH na City of Louisville KY 40211,Vehicle Fire,131,131 - Passenger vehicle fire,0,4000,4000,4000,0
11814,2016,Spring,4/26/2016,337 S PETERSON n/a City of Louisville KY 40206,Structure Fire,111,111 - Building fire,70000,15000,85000,285520,200520
11771,2016,Spring,4/26/2016,729 S 39TH na City of Louisville KY 40211,Vehicle Fire,131,131 - Passenger vehicle fire,0,4000,4000,4000,0
11814,2016,Spring,4/26/2016,337 S PETERSON n/a City of Louisville KY 40206,Structure Fire,111,111 - Building fire,70000,15000,85000,285520,200520
11771,2016,Spring,4/26/2016,729 S 39TH na City of Louisville KY 40211,Vehicle Fire,131,131 - Passenger vehicle fire,0,4000,4000,4000,0
11814,2016,Spring,4/26/2016,337 S PETERSON n/a City of Louisville KY 40206,Structure Fire,111,111 - Building fire,70000,15000,85000,285520,200520
11903,2016,Spring,4/27/2016,2705 TAYLOR n/a City of Louisville KY 40208,Structure Fire,111,111 - Building fire,2000,2000,4000,2000,-2000
11903,2016,Spring,4/27/2016,2705 TAYLOR n/a City of Louisville KY 40208,Structure Fire,111,111 - Building fire,2000,2000,4000,2000,-2000
11903,2016,Spring,4/27/2016,2705 TAYLOR n/a City of Louisville KY 40208,Structure Fire,111,111 - Building fire,2000,2000,4000,2000,-2000
12046,2016,Spring,4/28/2016,1605 ALGONQUIN N/A City of Louisville KY 40210,Structure Fire,111,111 - Building fire,350,0,350,NULL,NULL
12046,2016,Spring,4/28/2016,1605 ALGONQUIN N/A City of Louisville KY 40210,Structure Fire,111,111 - Building fire,350,0,350,NULL,NULL
12046,2016,Spring,4/28/2016,1605 ALGONQUIN N/A City of Louisville KY 40210,Structure Fire,111,111 - Building fire,350,0,350,NULL,NULL
12155,2016,Spring,4/29/2016,3601 GEORGETOWN na City of Louisville KY 40215,Structure Fire,111,111 - Building fire,0,80000,80000,80000,0
12155,2016,Spring,4/29/2016,3601 GEORGETOWN na City of Louisville KY 40215,Structure Fire,111,111 - Building fire,0,80000,80000,80000,0
12155,2016,Spring,4/29/2016,3601 GEORGETOWN na City of Louisville KY 40215,Structure Fire,111,111 - Building fire,0,80000,80000,80000,0
12279,2016,Summer,5/1/2016,3315 PALMER N/A City of Louisville KY 40218,Structure Fire,111,111 - Building fire,50,500,550,142690,142140
12279,2016,Summer,5/1/2016,3315 PALMER N/A City of Louisville KY 40218,Structure Fire,111,111 - Building fire,50,500,550,142690,142140
12279,2016,Summer,5/1/2016,3315 PALMER N/A City of Louisville KY 40218,Structure Fire,111,111 - Building fire,50,500,550,142690,142140
12479,2016,Summer,5/2/2016,1719 PATTON B City of Louisville KY 40210,Structure Fire,113,"113 - Cooking fire, confined to container",500,1000,1500,1000,-500
12479,2016,Summer,5/2/2016,1719 PATTON B City of Louisville KY 40210,Structure Fire,113,"113 - Cooking fire, confined to container",500,1000,1500,1000,-500
12479,2016,Summer,5/2/2016,1719 PATTON B City of Louisville KY 40210,Structure Fire,113,"113 - Cooking fire, confined to container",500,1000,1500,1000,-500
12534,2016,Summer,5/3/2016,N 29TH City of Louisville KY 40212,Vehicle Fire,134,134 - Water vehicle fire,1000,15000,16000,15000,-1000
12552,2016,Summer,5/3/2016,415 E MUHAMMAD ALI 1612 City of Louisville KY 40202,Structure Fire,111,111 - Building fire,100,500,600,500,-100
12534,2016,Summer,5/3/2016,N 29TH City of Louisville KY 40212,Vehicle Fire,134,134 - Water vehicle fire,1000,15000,16000,15000,-1000
12552,2016,Summer,5/3/2016,415 E MUHAMMAD ALI 1612 City of Louisville KY 40202,Structure Fire,111,111 - Building fire,100,500,600,500,-100
12534,2016,Summer,5/3/2016,N 29TH City of Louisville KY 40212,Vehicle Fire,134,134 - Water vehicle fire,1000,15000,16000,15000,-1000
12552,2016,Summer,5/3/2016,415 E MUHAMMAD ALI 1612 City of Louisville KY 40202,Structure Fire,111,111 - Building fire,100,500,600,500,-100
12597,2016,Summer,5/4/2016,136 E SOUTHLAND n/a City of Louisville KY 40214,Vehicle Fire,131,131 - Passenger vehicle fire,1000,3000,4000,3000,-1000
12634,2016,Summer,5/4/2016,3825 S 38TH N/A City of Louisville KY 40212,Structure Fire,111,111 - Building fire,0,100,100,86320,86220
12597,2016,Summer,5/4/2016,136 E SOUTHLAND n/a City of Louisville KY 40214,Vehicle Fire,131,131 - Passenger vehicle fire,1000,3000,4000,3000,-1000
12634,2016,Summer,5/4/2016,3825 S 38TH N/A City of Louisville KY 40212,Structure Fire,111,111 - Building fire,0,100,100,86320,86220
12597,2016,Summer,5/4/2016,136 E SOUTHLAND n/a City of Louisville KY 40214,Vehicle Fire,131,131 - Passenger vehicle fire,1000,3000,4000,3000,-1000
12634,2016,Summer,5/4/2016,3825 S 38TH N/A City of Louisville KY 40212,Structure Fire,111,111 - Building fire,0,100,100,86320,86220
12829,2016,Summer,5/6/2016,1729 BELMAR n/a City of Audubon Park KY 40213,Structure Fire,111,111 - Building fire,50000,120000,170000,120000,-50000
12836,2016,Summer,5/6/2016,3632 VERMONT na City of Louisville KY 40211,Structure Fire,111,111 - Building fire,500,29200,29700,29200,-500
12829,2016,Summer,5/6/2016,1729 BELMAR n/a City of Audubon Park KY 40213,Structure Fire,111,111 - Building fire,50000,120000,170000,120000,-50000
12836,2016,Summer,5/6/2016,3632 VERMONT na City of Louisville KY 40211,Structure Fire,111,111 - Building fire,500,29200,29700,29200,-500
12829,2016,Summer,5/6/2016,1729 BELMAR n/a City of Audubon Park KY 40213,Structure Fire,111,111 - Building fire,50000,120000,170000,120000,-50000
12836,2016,Summer,5/6/2016,3632 VERMONT na City of Louisville KY 40211,Structure Fire,111,111 - Building fire,500,29200,29700,29200,-500
12878,2016,Summer,5/6/2016,120 W BROADWAY basement City of Louisville KY 40202,Structure Fire,111,111 - Building fire,50,1200,1250,2000,750
12878,2016,Summer,5/6/2016,120 W BROADWAY basement City of Louisville KY 40202,Structure Fire,111,111 - Building fire,50,1200,1250,2000,750
12878,2016,Summer,5/6/2016,120 W BROADWAY basement City of Louisville KY 40202,Structure Fire,111,111 - Building fire,50,1200,1250,2000,750
12994,2016,Summer,5/7/2016,S 22ND City of Louisville KY 40211,Vehicle Fire,131,131 - Passenger vehicle fire,0,5000,5000,10000,5000
12994,2016,Summer,5/7/2016,S 22ND City of Louisville KY 40211,Vehicle Fire,131,131 - Passenger vehicle fire,0,5000,5000,10000,5000
12994,2016,Summer,5/7/2016,S 22ND City of Louisville KY 40211,Vehicle Fire,131,131 - Passenger vehicle fire,0,5000,5000,10000,5000
13064,2016,Summer,5/8/2016,GOLDSMITH City of Kingsley KY 40205,Vehicle Fire,131,131 - Passenger vehicle fire,0,500,500,3000,2500
13064,2016,Summer,5/8/2016,GOLDSMITH City of Kingsley KY 40205,Vehicle Fire,131,131 - Passenger vehicle fire,0,500,500,3000,2500
13064,2016,Summer,5/8/2016,GOLDSMITH City of Kingsley KY 40205,Vehicle Fire,131,131 - Passenger vehicle fire,0,500,500,3000,2500
13124,2016,Summer,5/9/2016,619 S 19TH 0 City of Louisville KY 40203,Structure Fire,111,111 - Building fire,100,100,200,100,-100
13133,2016,Summer,5/9/2016,TAYLOR City of Louisville KY 40208,Vehicle Fire,131,131 - Passenger vehicle fire,0,1000,1000,1000,0
13163,2016,Summer,5/9/2016,1435 S 9TH n/a City of Louisville KY 40208,Structure Fire,111,111 - Building fire,5000,7000,12000,14000,2000
13188,2016,Summer,5/9/2016,780 LOGAN NA City of Louisville KY 40203,Vehicle Fire,131,131 - Passenger vehicle fire,0,5000,5000,5000,0
13124,2016,Summer,5/9/2016,619 S 19TH 0 City of Louisville KY 40203,Structure Fire,111,111 - Building fire,100,100,200,100,-100
13133,2016,Summer,5/9/2016,TAYLOR City of Louisville KY 40208,Vehicle Fire,131,131 - Passenger vehicle fire,0,1000,1000,1000,0
13163,2016,Summer,5/9/2016,1435 S 9TH n/a City of Louisville KY 40208,Structure Fire,111,111 - Building fire,5000,7000,12000,14000,2000
13188,2016,Summer,5/9/2016,780 LOGAN NA City of Louisville KY 40203,Vehicle Fire,131,131 - Passenger vehicle fire,0,5000,5000,5000,0
13124,2016,Summer,5/9/2016,619 S 19TH 0 City of Louisville KY 40203,Structure Fire,111,111 - Building fire,100,100,200,100,-100
13133,2016,Summer,5/9/2016,TAYLOR City of Louisville KY 40208,Vehicle Fire,131,131 - Passenger vehicle fire,0,1000,1000,1000,0
13163,2016,Summer,5/9/2016,1435 S 9TH n/a City of Louisville KY 40208,Structure Fire,111,111 - Building fire,5000,7000,12000,14000,2000
13188,2016,Summer,5/9/2016,780 LOGAN NA City of Louisville KY 40203,Vehicle Fire,131,131 - Passenger vehicle fire,0,5000,5000,5000,0
13475,2016,Summer,5/12/2016,2718 W CHESTNUT N/A City of Louisville KY 40211,Vehicle Fire,131,131 - Passenger vehicle fire,0,10000,10000,10000,0
13551,2016,Summer,5/12/2016,1200 S 2ND 11 City of Louisville KY 40203,Structure Fire,113,"113 - Cooking fire, confined to container",500,500,1000,500,-500
13475,2016,Summer,5/12/2016,2718 W CHESTNUT N/A City of Louisville KY 40211,Vehicle Fire,131,131 - Passenger vehicle fire,0,10000,10000,10000,0
13551,2016,Summer,5/12/2016,1200 S 2ND 11 City of Louisville KY 40203,Structure Fire,113,"113 - Cooking fire, confined to container",500,500,1000,500,-500
13475,2016,Summer,5/12/2016,2718 W CHESTNUT N/A City of Louisville KY 40211,Vehicle Fire,131,131 - Passenger vehicle fire,0,10000,10000,10000,0
13551,2016,Summer,5/12/2016,1200 S 2ND 11 City of Louisville KY 40203,Structure Fire,113,"113 - Cooking fire, confined to container",500,500,1000,500,-500
13674,2016,Summer,5/13/2016,1225 S 1ST 4 City of Louisville KY 40203,Structure Fire,111,111 - Building fire,5000,10000,15000,171600,156600
13674,2016,Summer,5/13/2016,1225 S 1ST 4 City of Louisville KY 40203,Structure Fire,111,111 - Building fire,5000,10000,15000,171600,156600
13674,2016,Summer,5/13/2016,1225 S 1ST 4 City of Louisville KY 40203,Structure Fire,111,111 - Building fire,5000,10000,15000,171600,156600
13688,2016,Summer,5/14/2016,1610 WILLIAM E SUMMERS III 100 City of Louisville KY 40211,Structure Fire,111,111 - Building fire,2000,15000,17000,300000,283000
13750,2016,Summer,5/14/2016,4500 S 3RD n/a City of Louisville KY 40214,Vehicle Fire,131,131 - Passenger vehicle fire,0,1500,1500,2200,700
13688,2016,Summer,5/14/2016,1610 WILLIAM E SUMMERS III 100 City of Louisville KY 40211,Structure Fire,111,111 - Building fire,2000,15000,17000,300000,283000
13750,2016,Summer,5/14/2016,4500 S 3RD n/a City of Louisville KY 40214,Vehicle Fire,131,131 - Passenger vehicle fire,0,1500,1500,2200,700
13688,2016,Summer,5/14/2016,1610 WILLIAM E SUMMERS III 100 City of Louisville KY 40211,Structure Fire,111,111 - Building fire,2000,15000,17000,300000,283000
13750,2016,Summer,5/14/2016,4500 S 3RD n/a City of Louisville KY 40214,Vehicle Fire,131,131 - Passenger vehicle fire,0,1500,1500,2200,700
13816,2016,Summer,5/15/2016,7415 JUDY 6 City of Louisville KY 40214,Structure Fire,111,111 - Building fire,2000,15000,17000,1167000,1150000
13819,2016,Summer,5/15/2016,S 18TH City of Louisville KY 40203,Vehicle Fire,131,131 - Passenger vehicle fire,0,6000,6000,6000,0
13846,2016,Summer,5/15/2016,301 N 26TH N/A City of Louisville KY 40212,Structure Fire,111,111 - Building fire,0,41710,41710,41710,0
13846,2016,Summer,5/15/2016,303 N 26TH N/A City of Louisville KY 40212,Structure Fire,111,111 - Building fire,0,4000,4000,21490,17490
13816,2016,Summer,5/15/2016,7415 JUDY 6 City of Louisville KY 40214,Structure Fire,111,111 - Building fire,2000,15000,17000,1167000,1150000
13819,2016,Summer,5/15/2016,S 18TH City of Louisville KY 40203,Vehicle Fire,131,131 - Passenger vehicle fire,0,6000,6000,6000,0
13846,2016,Summer,5/15/2016,303 N 26TH N/A City of Louisville KY 40212,Structure Fire,111,111 - Building fire,0,4000,4000,21490,17490
13846,2016,Summer,5/15/2016,301 N 26TH N/A City of Louisville KY 40212,Structure Fire,111,111 - Building fire,0,41710,41710,41710,0
13846,2016,Summer,5/15/2016,303 N 26TH N/A City of Louisville KY 40212,Structure Fire,111,111 - Building fire,0,4000,4000,21490,17490
13816,2016,Summer,5/15/2016,7415 JUDY 6 City of Louisville KY 40214,Structure Fire,111,111 - Building fire,2000,15000,17000,1167000,1150000
13819,2016,Summer,5/15/2016,S 18TH City of Louisville KY 40203,Vehicle Fire,131,131 - Passenger vehicle fire,0,6000,6000,6000,0
13846,2016,Summer,5/15/2016,301 N 26TH N/A City of Louisville KY 40212,Structure Fire,111,111 - Building fire,0,41710,41710,41710,0
13969,2016,Summer,5/17/2016,I 64 East City of Louisville KY 40203,Vehicle Fire,131,131 - Passenger vehicle fire,0,500,500,5000,4500
13969,2016,Summer,5/17/2016,I 64 East City of Louisville KY 40203,Vehicle Fire,131,131 - Passenger vehicle fire,0,500,500,5000,4500
13969,2016,Summer,5/17/2016,I 64 East City of Louisville KY 40203,Vehicle Fire,131,131 - Passenger vehicle fire,0,500,500,5000,4500
14248,2016,Summer,5/20/2016,647 N 24TH N/A City of Louisville KY 40212,Structure Fire,111,111 - Building fire,0,10000,10000,10000,0
14267,2016,Summer,5/20/2016,3008 TAYLOR backyard City of Louisville KY 40208,Structure Fire,118,"118 - Trash or rubbish fire, contained",0,100,100,28270,28170
14328,2016,Summer,5/20/2016,3914 PFLANZ N/A City of Louisville KY 40212,Structure Fire,111,111 - Building fire,1000,1000,2000,33950,31950
14248,2016,Summer,5/20/2016,649 N 24TH N/A City of Louisville KY 40212,Structure Fire,111,111 - Building fire,500,2000,2500,30830,28330
14248,2016,Summer,5/20/2016,645 N 24TH N/A City of Louisville KY 40212,Structure Fire,111,111 - Building fire,0,1000,1000,22760,21760
14248,2016,Summer,5/20/2016,2322 NORTHWESTERN na City of Louisville KY 40212,Structure Fire,111,111 - Building fire,1000,1000,2000,37040,35040
14248,2016,Summer,5/20/2016,647 N 24TH N/A City of Louisville KY 40212,Structure Fire,111,111 - Building fire,0,10000,10000,10000,0
14248,2016,Summer,5/20/2016,2322 NORTHWESTERN na City of Louisville KY 40212,Structure Fire,111,111 - Building fire,1000,1000,2000,37040,35040
14248,2016,Summer,5/20/2016,647 N 24TH N/A City of Louisville KY 40212,Structure Fire,111,111 - Building fire,0,10000,10000,10000,0
14267,2016,Summer,5/20/2016,3008 TAYLOR backyard City of Louisville KY 40208,Structure Fire,118,"118 - Trash or rubbish fire, contained",0,100,100,28270,28170
14328,2016,Summer,5/20/2016,3914 PFLANZ N/A City of Louisville KY 40212,Structure Fire,111,111 - Building fire,1000,1000,2000,33950,31950
14248,2016,Summer,5/20/2016,649 N 24TH N/A City of Louisville KY 40212,Structure Fire,111,111 - Building fire,500,2000,2500,30830,28330
14248,2016,Summer,5/20/2016,645 N 24TH N/A City of Louisville KY 40212,Structure Fire,111,111 - Building fire,0,1000,1000,22760,21760
14248,2016,Summer,5/20/2016,2322 NORTHWESTERN na City of Louisville KY 40212,Structure Fire,111,111 - Building fire,1000,1000,2000,37040,35040
14267,2016,Summer,5/20/2016,3008 TAYLOR backyard City of Louisville KY 40208,Structure Fire,118,"118 - Trash or rubbish fire, contained",0,100,100,28270,28170
14248,2016,Summer,5/20/2016,649 N 24TH N/A City of Louisville KY 40212,Structure Fire,111,111 - Building fire,500,2000,2500,30830,28330
14248,2016,Summer,5/20/2016,645 N 24TH N/A City of Louisville KY 40212,Structure Fire,111,111 - Building fire,0,1000,1000,22760,21760
14248,2016,Summer,5/20/2016,2322 NORTHWESTERN na City of Louisville KY 40212,Structure Fire,111,111 - Building fire,1000,1000,2000,37040,35040
14328,2016,Summer,5/20/2016,3914 PFLANZ N/A City of Louisville KY 40212,Structure Fire,111,111 - Building fire,1000,1000,2000,33950,31950
14680,2016,Summer,5/23/2016,1210 CENTRAL kitchen City of Louisville KY 40208,Structure Fire,113,"113 - Cooking fire, confined to container",0,50,50,52000,51950
14685,2016,Summer,5/23/2016,1210 SALE backyard City of Louisville KY 40215,Outside Fire,161,161 - Outside storage fire,0,50,50,2000,1950
14696,2016,Summer,5/23/2016,1507 W MARKET n/a City of Louisville KY 40203,Structure Fire,111,111 - Building fire,0,20000,20000,40000,20000
14700,2016,Summer,5/23/2016,1631 W MARKET NA City of Louisville KY 40203,Outside Fire,162,162 - Outside equipment fire,100,0,100,0,-100
14680,2016,Summer,5/23/2016,1210 CENTRAL kitchen City of Louisville KY 40208,Structure Fire,113,"113 - Cooking fire, confined to container",0,50,50,52000,51950
14685,2016,Summer,5/23/2016,1210 SALE backyard City of Louisville KY 40215,Outside Fire,161,161 - Outside storage fire,0,50,50,2000,1950
14696,2016,Summer,5/23/2016,1507 W MARKET n/a City of Louisville KY 40203,Structure Fire,111,111 - Building fire,0,20000,20000,40000,20000
14700,2016,Summer,5/23/2016,1631 W MARKET NA City of Louisville KY 40203,Outside Fire,162,162 - Outside equipment fire,100,0,100,0,-100
14680,2016,Summer,5/23/2016,1210 CENTRAL kitchen City of Louisville KY 40208,Structure Fire,113,"113 - Cooking fire, confined to container",0,50,50,52000,51950
14685,2016,Summer,5/23/2016,1210 SALE backyard City of Louisville KY 40215,Outside Fire,161,161 - Outside storage fire,0,50,50,2000,1950
14696,2016,Summer,5/23/2016,1507 W MARKET n/a City of Louisville KY 40203,Structure Fire,111,111 - Building fire,0,20000,20000,40000,20000
14700,2016,Summer,5/23/2016,1631 W MARKET NA City of Louisville KY 40203,Outside Fire,162,162 - Outside equipment fire,100,0,100,0,-100
14850,2016,Summer,5/25/2016,2414 MONTGOMERY none City of Louisville KY 40212,Structure Fire,111,111 - Building fire,10000,24210,34210,24210,-10000
14850,2016,Summer,5/25/2016,2414 MONTGOMERY none City of Louisville KY 40212,Structure Fire,111,111 - Building fire,10000,24210,34210,24210,-10000
14850,2016,Summer,5/25/2016,2414 MONTGOMERY none City of Louisville KY 40212,Structure Fire,111,111 - Building fire,10000,24210,34210,24210,-10000
14964,2016,Summer,5/26/2016,3762 UNION N/A City of Audubon Park KY 40213,Structure Fire,111,111 - Building fire,10000,40000,50000,73120,23120
14965,2016,Summer,5/26/2016,S 32ND City of Louisville KY 40211,Structure Fire,111,111 - Building fire,0,1000,1000,209660,208660
15093,2016,Summer,5/26/2016,S 44TH City of Louisville KY 40212,Vehicle Fire,131,131 - Passenger vehicle fire,0,5000,5000,5000,0
15093,2016,Summer,5/26/2016,S 44TH City of Louisville KY 40212,Vehicle Fire,131,131 - Passenger vehicle fire,0,5000,5000,5000,0
14964,2016,Summer,5/26/2016,3762 UNION N/A City of Audubon Park KY 40213,Structure Fire,111,111 - Building fire,10000,40000,50000,73120,23120
14965,2016,Summer,5/26/2016,S 32ND City of Louisville KY 40211,Structure Fire,111,111 - Building fire,0,1000,1000,209660,208660
15093,2016,Summer,5/26/2016,S 44TH City of Louisville KY 40212,Vehicle Fire,131,131 - Passenger vehicle fire,0,5000,5000,5000,0
14964,2016,Summer,5/26/2016,3762 UNION N/A City of Audubon Park KY 40213,Structure Fire,111,111 - Building fire,10000,40000,50000,73120,23120
14965,2016,Summer,5/26/2016,S 32ND City of Louisville KY 40211,Structure Fire,111,111 - Building fire,0,1000,1000,209660,208660
15178,2016,Summer,5/27/2016,2323 ROWAN NA City of Louisville KY 40212,Structure Fire,111,111 - Building fire,0,22990,22990,22990,0
15178,2016,Summer,5/27/2016,2323 ROWAN NA City of Louisville KY 40212,Structure Fire,111,111 - Building fire,0,22990,22990,22990,0
15178,2016,Summer,5/27/2016,2325 ROWAN NA City of Louisville KY 40212,Structure Fire,111,111 - Building fire,0,1000,1000,20850,19850
15178,2016,Summer,5/27/2016,2323 ROWAN NA City of Louisville KY 40212,Structure Fire,111,111 - Building fire,0,22990,22990,22990,0
15178,2016,Summer,5/27/2016,2325 ROWAN NA City of Louisville KY 40212,Structure Fire,111,111 - Building fire,0,1000,1000,20850,19850
15178,2016,Summer,5/27/2016,2325 ROWAN NA City of Louisville KY 40212,Structure Fire,111,111 - Building fire,0,1000,1000,20850,19850
15300,2016,Summer,5/28/2016,4519 S 3RD 1 City of Louisville KY 40214,Structure Fire,111,111 - Building fire,0,500,500,75000,74500
15300,2016,Summer,5/28/2016,4519 S 3RD 1 City of Louisville KY 40214,Structure Fire,111,111 - Building fire,0,500,500,75000,74500
15300,2016,Summer,5/28/2016,4519 S 3RD 1 City of Louisville KY 40214,Structure Fire,111,111 - Building fire,0,500,500,75000,74500
15394,2016,Summer,5/29/2016,1003 E BRECKINRIDGE 2 City of Louisville KY 40204,Structure Fire,111,111 - Building fire,0,100,100,100,0
15394,2016,Summer,5/29/2016,1003 E BRECKINRIDGE 2 City of Louisville KY 40204,Structure Fire,111,111 - Building fire,0,100,100,100,0
15394,2016,Summer,5/29/2016,1003 E BRECKINRIDGE 2 City of Louisville KY 40204,Structure Fire,111,111 - Building fire,0,100,100,100,0
15468,2016,Summer,5/30/2016,2002 PAYNE na City of Louisville KY 40206,Vehicle Fire,131,131 - Passenger vehicle fire,0,3000,3000,10000,7000
15494,2016,Summer,5/30/2016,2204 W CHESTNUT n/a City of Louisville KY 40211,Structure Fire,111,111 - Building fire,2500,15000,17500,62670,45170
15512,2016,Summer,5/30/2016,I 71 South City of Beechwood Village KY 40207,Vehicle Fire,131,131 - Passenger vehicle fire,0,8000,8000,8000,0
15539,2016,Summer,5/30/2016,DIXIE City of Louisville KY 40210,Vehicle Fire,131,131 - Passenger vehicle fire,500,3000,3500,3000,-500
15544,2016,Summer,5/30/2016,1825 BURWELL n/a City of Louisville KY 40210,Vehicle Fire,131,131 - Passenger vehicle fire,0,5000,5000,5000,0
15468,2016,Summer,5/30/2016,2002 PAYNE na City of Louisville KY 40206,Vehicle Fire,131,131 - Passenger vehicle fire,0,3000,3000,10000,7000
15494,2016,Summer,5/30/2016,2204 W CHESTNUT n/a City of Louisville KY 40211,Structure Fire,111,111 - Building fire,2500,15000,17500,62670,45170
15512,2016,Summer,5/30/2016,I 71 South City of Beechwood Village KY 40207,Vehicle Fire,131,131 - Passenger vehicle fire,0,8000,8000,8000,0
15539,2016,Summer,5/30/2016,DIXIE City of Louisville KY 40210,Vehicle Fire,131,131 - Passenger vehicle fire,500,3000,3500,3000,-500
15544,2016,Summer,5/30/2016,1825 BURWELL n/a City of Louisville KY 40210,Vehicle Fire,131,131 - Passenger vehicle fire,0,5000,5000,5000,0
15468,2016,Summer,5/30/2016,2002 PAYNE na City of Louisville KY 40206,Vehicle Fire,131,131 - Passenger vehicle fire,0,3000,3000,10000,7000
15494,2016,Summer,5/30/2016,2204 W CHESTNUT n/a City of Louisville KY 40211,Structure Fire,111,111 - Building fire,2500,15000,17500,62670,45170
15512,2016,Summer,5/30/2016,I 71 South City of Beechwood Village KY 40207,Vehicle Fire,131,131 - Passenger vehicle fire,0,8000,8000,8000,0
15539,2016,Summer,5/30/2016,DIXIE City of Louisville KY 40210,Vehicle Fire,131,131 - Passenger vehicle fire,500,3000,3500,3000,-500
15544,2016,Summer,5/30/2016,1825 BURWELL n/a City of Louisville KY 40210,Vehicle Fire,131,131 - Passenger vehicle fire,0,5000,5000,5000,0
15604,2016,Summer,5/31/2016,3837 RIVER PARK n/a City of Louisville KY 40211,Structure Fire,111,111 - Building fire,2500,12000,14500,31300,16800
15604,2016,Summer,5/31/2016,3837 RIVER PARK n/a City of Louisville KY 40211,Structure Fire,111,111 - Building fire,2500,12000,14500,31300,16800
15604,2016,Summer,5/31/2016,3839 RIVER PARK n/a City of Louisville KY 40211,Structure Fire,111,111 - Building fire,0,500,500,30860,30360
15604,2016,Summer,5/31/2016,3837 RIVER PARK n/a City of Louisville KY 40211,Structure Fire,111,111 - Building fire,2500,12000,14500,31300,16800
15604,2016,Summer,5/31/2016,3839 RIVER PARK n/a City of Louisville KY 40211,Structure Fire,111,111 - Building fire,0,500,500,30860,30360
15604,2016,Summer,5/31/2016,3839 RIVER PARK n/a City of Louisville KY 40211,Structure Fire,111,111 - Building fire,0,500,500,30860,30360
15662,2016,Summer,6/1/2016,DURRETT City of Audubon Park KY 40213,Vehicle Fire,131,131 - Passenger vehicle fire,0,7500,7500,7500,0
15712,2016,Summer,6/1/2016,4201 LARKWOOD 2 City of Louisville KY 40212,Structure Fire,111,111 - Building fire,3000,15000,18000,65000,47000
15662,2016,Summer,6/1/2016,DURRETT City of Audubon Park KY 40213,Vehicle Fire,131,131 - Passenger vehicle fire,0,7500,7500,7500,0
15662,2016,Summer,6/1/2016,DURRETT City of Audubon Park KY 40213,Vehicle Fire,131,131 - Passenger vehicle fire,0,7500,7500,7500,0
15712,2016,Summer,6/1/2016,4201 LARKWOOD 2 City of Louisville KY 40212,Structure Fire,111,111 - Building fire,3000,15000,18000,65000,47000
15712,2016,Summer,6/1/2016,4201 LARKWOOD 2 City of Louisville KY 40212,Structure Fire,111,111 - Building fire,3000,15000,18000,65000,47000
15866,2016,Summer,6/2/2016,3309 HIKES n/a City of Cambridge KY 40220,Structure Fire,111,111 - Building fire,10000,25000,35000,180000,145000
15866,2016,Summer,6/2/2016,3309 HIKES n/a City of Cambridge KY 40220,Structure Fire,111,111 - Building fire,10000,25000,35000,180000,145000
15866,2016,Summer,6/2/2016,3309 HIKES n/a City of Cambridge KY 40220,Structure Fire,111,111 - Building fire,10000,25000,35000,180000,145000
16037,2016,Summer,6/4/2016,1653 HALE N/A City of Louisville KY 40210,Structure Fire,111,111 - Building fire,5000,15000,20000,25000,5000
16037,2016,Summer,6/4/2016,1653 HALE N/A City of Louisville KY 40210,Structure Fire,111,111 - Building fire,5000,15000,20000,25000,5000
16137,2016,Summer,6/4/2016,1030 DRESDEN na City of Louisville KY 40215,Structure Fire,111,111 - Building fire,0,10000,10000,10000,0
16137,2016,Summer,6/4/2016,1030 DRESDEN na City of Louisville KY 40215,Structure Fire,111,111 - Building fire,0,10000,10000,10000,0
16137,2016,Summer,6/4/2016,1030 DRESDEN na City of Louisville KY 40215,Structure Fire,111,111 - Building fire,0,10000,10000,10000,0
16037,2016,Summer,6/4/2016,1653 HALE N/A City of Louisville KY 40210,Structure Fire,111,111 - Building fire,5000,15000,20000,25000,5000
16245,2016,Summer,6/5/2016,4520 S 3RD n/a City of Louisville KY 40214,Vehicle Fire,131,131 - Passenger vehicle fire,0,800,800,800,0
16245,2016,Summer,6/5/2016,4520 S 3RD n/a City of Louisville KY 40214,Vehicle Fire,131,131 - Passenger vehicle fire,0,800,800,800,0
16245,2016,Summer,6/5/2016,4520 S 3RD n/a City of Louisville KY 40214,Vehicle Fire,131,131 - Passenger vehicle fire,0,800,800,800,0
16448,2016,Summer,6/7/2016,2307 W OAK N/A City of Louisville KY 40210,Structure Fire,111,111 - Building fire,1000,100,1100,80000,78900
16448,2016,Summer,6/7/2016,2307 W OAK N/A City of Louisville KY 40210,Structure Fire,111,111 - Building fire,1000,100,1100,80000,78900
16448,2016,Summer,6/7/2016,2307 W OAK N/A City of Louisville KY 40210,Structure Fire,111,111 - Building fire,1000,100,1100,80000,78900
16463,2016,Summer,6/8/2016,I 264 West City of Louisville KY 40211,Vehicle Fire,131,131 - Passenger vehicle fire,1000,10000,11000,10000,-1000
16468,2016,Summer,6/8/2016,N 35TH City of Louisville KY 40212,Vehicle Fire,131,131 - Passenger vehicle fire,1000,6000,7000,6000,-1000
16473,2016,Summer,6/8/2016,4213 W BROADWAY N/A City of Louisville KY 40211,Vehicle Fire,136,136 - Self-propelled motor home or recreational vehicle,2000,8000,10000,8000,-2000
16484,2016,Summer,6/8/2016,S 17TH City of Louisville KY 40210,Vehicle Fire,131,131 - Passenger vehicle fire,0,2000,2000,2000,0
16497,2016,Summer,6/8/2016,4502 SOUTHCREST na City of Louisville KY 40215,Structure Fire,111,111 - Building fire,2000,10000,12000,10000,-2000
16557,2016,Summer,6/8/2016,I 264 East n/a City of Cambridge KY 40220,Vehicle Fire,131,131 - Passenger vehicle fire,100,6000,6100,6000,-100
16567,2016,Summer,6/8/2016,1025 CALDWELL n/a City of Louisville KY 40204,Structure Fire,111,111 - Building fire,0,15000,15000,170000,155000
16578,2016,Summer,6/8/2016,405 W OAK n/a City of Louisville KY 40203,Structure Fire,111,111 - Building fire,5000,0,5000,0,-5000
16473,2016,Summer,6/8/2016,4215 W BROADWAY N/A City of Louisville KY 40211,Structure Fire,111,111 - Building fire,0,1000,1000,102290,101290
16473,2016,Summer,6/8/2016,4213 W BROADWAY N/A City of Louisville KY 40211,Vehicle Fire,131,131 - Passenger vehicle fire,0,1000,1000,1323,323
16463,2016,Summer,6/8/2016,I 264 West City of Louisville KY 40211,Vehicle Fire,131,131 - Passenger vehicle fire,1000,10000,11000,10000,-1000
16468,2016,Summer,6/8/2016,N 35TH City of Louisville KY 40212,Vehicle Fire,131,131 - Passenger vehicle fire,1000,6000,7000,6000,-1000
16473,2016,Summer,6/8/2016,4213 W BROADWAY N/A City of Louisville KY 40211,Vehicle Fire,136,136 - Self-propelled motor home or recreational vehicle,2000,8000,10000,8000,-2000
16484,2016,Summer,6/8/2016,S 17TH City of Louisville KY 40210,Vehicle Fire,131,131 - Passenger vehicle fire,0,2000,2000,2000,0
16497,2016,Summer,6/8/2016,4502 SOUTHCREST na City of Louisville KY 40215,Structure Fire,111,111 - Building fire,2000,10000,12000,10000,-2000
16473,2016,Summer,6/8/2016,4215 W BROADWAY N/A City of Louisville KY 40211,Structure Fire,111,111 - Building fire,0,1000,1000,102290,101290
16473,2016,Summer,6/8/2016,4213 W BROADWAY N/A City of Louisville KY 40211,Vehicle Fire,131,131 - Passenger vehicle fire,0,1000,1000,1323,323
16557,2016,Summer,6/8/2016,I 264 East n/a City of Cambridge KY 40220,Vehicle Fire,131,131 - Passenger vehicle fire,100,6000,6100,6000,-100
16567,2016,Summer,6/8/2016,1025 CALDWELL n/a City of Louisville KY 40204,Structure Fire,111,111 - Building fire,0,15000,15000,170000,155000
16578,2016,Summer,6/8/2016,405 W OAK n/a City of Louisville KY 40203,Structure Fire,111,111 - Building fire,5000,0,5000,0,-5000
16463,2016,Summer,6/8/2016,I 264 West City of Louisville KY 40211,Vehicle Fire,131,131 - Passenger vehicle fire,1000,10000,11000,10000,-1000
16468,2016,Summer,6/8/2016,N 35TH City of Louisville KY 40212,Vehicle Fire,131,131 - Passenger vehicle fire,1000,6000,7000,6000,-1000
16473,2016,Summer,6/8/2016,4213 W BROADWAY N/A City of Louisville KY 40211,Vehicle Fire,136,136 - Self-propelled motor home or recreational vehicle,2000,8000,10000,8000,-2000
16484,2016,Summer,6/8/2016,S 17TH City of Louisville KY 40210,Vehicle Fire,131,131 - Passenger vehicle fire,0,2000,2000,2000,0
16497,2016,Summer,6/8/2016,4502 SOUTHCREST na City of Louisville KY 40215,Structure Fire,111,111 - Building fire,2000,10000,12000,10000,-2000
16557,2016,Summer,6/8/2016,I 264 East n/a City of Cambridge KY 40220,Vehicle Fire,131,131 - Passenger vehicle fire,100,6000,6100,6000,-100
16567,2016,Summer,6/8/2016,1025 CALDWELL n/a City of Louisville KY 40204,Structure Fire,111,111 - Building fire,0,15000,15000,170000,155000
16578,2016,Summer,6/8/2016,405 W OAK n/a City of Louisville KY 40203,Structure Fire,111,111 - Building fire,5000,0,5000,0,-5000
16473,2016,Summer,6/8/2016,4215 W BROADWAY N/A City of Louisville KY 40211,Structure Fire,111,111 - Building fire,0,1000,1000,102290,101290
16473,2016,Summer,6/8/2016,4213 W BROADWAY N/A City of Louisville KY 40211,Vehicle Fire,131,131 - Passenger vehicle fire,0,1000,1000,1323,323
16656,2016,Summer,6/9/2016,1036 HIGHLAND N/A City of Louisville KY 40204,Structure Fire,111,111 - Building fire,200,0,200,NULL,NULL
16657,2016,Summer,6/9/2016,2216 W OAK N/A City of Louisville KY 40210,Structure Fire,111,111 - Building fire,0,10000,10000,10000,0
16699,2016,Summer,6/9/2016,1426 CENTRAL N/A City of Louisville KY 40215,Structure Fire,111,111 - Building fire,0,4000,4000,100000,96000
16709,2016,Summer,6/9/2016,1824 DIXDALE N/A City of Louisville KY 40210,Structure Fire,113,"113 - Cooking fire, confined to container",1000,800,1800,90000,88200
16699,2016,Summer,6/9/2016,1426 CENTRAL N/A City of Louisville KY 40215,Structure Fire,111,111 - Building fire,0,4000,4000,100000,96000
16709,2016,Summer,6/9/2016,1824 DIXDALE N/A City of Louisville KY 40210,Structure Fire,113,"113 - Cooking fire, confined to container",1000,800,1800,90000,88200
16656,2016,Summer,6/9/2016,1036 HIGHLAND N/A City of Louisville KY 40204,Structure Fire,111,111 - Building fire,200,0,200,NULL,NULL
16657,2016,Summer,6/9/2016,2216 W OAK N/A City of Louisville KY 40210,Structure Fire,111,111 - Building fire,0,10000,10000,10000,0
16699,2016,Summer,6/9/2016,1426 CENTRAL N/A City of Louisville KY 40215,Structure Fire,111,111 - Building fire,0,4000,4000,100000,96000
16709,2016,Summer,6/9/2016,1824 DIXDALE N/A City of Louisville KY 40210,Structure Fire,113,"113 - Cooking fire, confined to container",1000,800,1800,90000,88200
16656,2016,Summer,6/9/2016,1036 HIGHLAND N/A City of Louisville KY 40204,Structure Fire,111,111 - Building fire,200,0,200,NULL,NULL
16657,2016,Summer,6/9/2016,2216 W OAK N/A City of Louisville KY 40210,Structure Fire,111,111 - Building fire,0,10000,10000,10000,0
16736,2016,Summer,6/10/2016,3539 RIVER PARK N/A City of Louisville KY 40211,Structure Fire,111,111 - Building fire,0,1000,1000,25900,24900
16736,2016,Summer,6/10/2016,3541 RIVER PARK N/A City of Louisville KY 40211,Structure Fire,111,111 - Building fire,5000,30000,35000,30120,-4880
16736,2016,Summer,6/10/2016,3539 RIVER PARK N/A City of Louisville KY 40211,Structure Fire,111,111 - Building fire,0,1000,1000,25900,24900
16736,2016,Summer,6/10/2016,3541 RIVER PARK N/A City of Louisville KY 40211,Structure Fire,111,111 - Building fire,5000,30000,35000,30120,-4880
16736,2016,Summer,6/10/2016,3539 RIVER PARK N/A City of Louisville KY 40211,Structure Fire,111,111 - Building fire,0,1000,1000,25900,24900
16736,2016,Summer,6/10/2016,3541 RIVER PARK N/A City of Louisville KY 40211,Structure Fire,111,111 - Building fire,5000,30000,35000,30120,-4880
16943,2016,Summer,6/11/2016,1021 BAXTER 1 City of Louisville KY 40204,Structure Fire,111,111 - Building fire,0,1000,1000,112180,111180
16952,2016,Summer,6/11/2016,627 ERVAY n/a City of Louisville KY 40217,Outside Fire,150,"150 - Outside rubbish fire, other",100,1000,1100,1000,-100
16943,2016,Summer,6/11/2016,1021 BAXTER 1 City of Louisville KY 40204,Structure Fire,111,111 - Building fire,0,1000,1000,112180,111180
16952,2016,Summer,6/11/2016,627 ERVAY n/a City of Louisville KY 40217,Outside Fire,150,"150 - Outside rubbish fire, other",100,1000,1100,1000,-100
16943,2016,Summer,6/11/2016,1021 BAXTER 1 City of Louisville KY 40204,Structure Fire,111,111 - Building fire,0,1000,1000,112180,111180
16952,2016,Summer,6/11/2016,627 ERVAY n/a City of Louisville KY 40217,Outside Fire,150,"150 - Outside rubbish fire, other",100,1000,1100,1000,-100
17075,2016,Summer,6/12/2016,2402 CLARENDON n/a City of Kingsley KY 40205,Structure Fire,111,111 - Building fire,10000,50000,60000,160000,100000
17122,2016,Summer,6/12/2016,1206 S PRESTON 4 City of Louisville KY 40203,Structure Fire,113,"113 - Cooking fire, confined to container",500,0,500,NULL,NULL
17075,2016,Summer,6/12/2016,2402 CLARENDON n/a City of Kingsley KY 40205,Structure Fire,111,111 - Building fire,10000,50000,60000,160000,100000
17122,2016,Summer,6/12/2016,1206 S PRESTON 4 City of Louisville KY 40203,Structure Fire,113,"113 - Cooking fire, confined to container",500,0,500,NULL,NULL
17075,2016,Summer,6/12/2016,2402 CLARENDON n/a City of Kingsley KY 40205,Structure Fire,111,111 - Building fire,10000,50000,60000,160000,100000
17122,2016,Summer,6/12/2016,1206 S PRESTON 4 City of Louisville KY 40203,Structure Fire,113,"113 - Cooking fire, confined to container",500,0,500,NULL,NULL
17328,2016,Summer,6/14/2016,N 6TH City of Louisville KY 40202,Vehicle Fire,131,131 - Passenger vehicle fire,0,1500,1500,1500,0
17334,2016,Summer,6/14/2016,2500 PORTLAND none City of Louisville KY 40212,Structure Fire,111,111 - Building fire,0,5000,5000,400000,395000
17328,2016,Summer,6/14/2016,N 6TH City of Louisville KY 40202,Vehicle Fire,131,131 - Passenger vehicle fire,0,1500,1500,1500,0
17334,2016,Summer,6/14/2016,2500 PORTLAND none City of Louisville KY 40212,Structure Fire,111,111 - Building fire,0,5000,5000,400000,395000
17328,2016,Summer,6/14/2016,N 6TH City of Louisville KY 40202,Vehicle Fire,131,131 - Passenger vehicle fire,0,1500,1500,1500,0
17334,2016,Summer,6/14/2016,2500 PORTLAND none City of Louisville KY 40212,Structure Fire,111,111 - Building fire,0,5000,5000,400000,395000
17752,2016,Summer,6/18/2016,301 ROCK CLIFF 3 City of Louisville KY 40218,Structure Fire,111,111 - Building fire,2500,10000,12500,300000,287500
17752,2016,Summer,6/18/2016,301 ROCK CLIFF 3 City of Louisville KY 40218,Structure Fire,111,111 - Building fire,2500,10000,12500,300000,287500
17752,2016,Summer,6/18/2016,301 ROCK CLIFF 3 City of Louisville KY 40218,Structure Fire,111,111 - Building fire,2500,10000,12500,300000,287500
17922,2016,Summer,6/20/2016,418 W ORMSBY 201 City of Louisville KY 40203,Structure Fire,111,111 - Building fire,0,500,500,40000,39500
17932,2016,Summer,6/20/2016,2202 JAMES PIRTLE 3 City of Louisville KY 40217,Structure Fire,111,111 - Building fire,50000,200000,250000,200000,-50000
17922,2016,Summer,6/20/2016,418 W ORMSBY 201 City of Louisville KY 40203,Structure Fire,111,111 - Building fire,0,500,500,40000,39500
17932,2016,Summer,6/20/2016,2202 JAMES PIRTLE 3 City of Louisville KY 40217,Structure Fire,111,111 - Building fire,50000,200000,250000,200000,-50000
17922,2016,Summer,6/20/2016,418 W ORMSBY 201 City of Louisville KY 40203,Structure Fire,111,111 - Building fire,0,500,500,40000,39500
17932,2016,Summer,6/20/2016,2202 JAMES PIRTLE 3 City of Louisville KY 40217,Structure Fire,111,111 - Building fire,50000,200000,250000,200000,-50000
18014,2016,Summer,6/21/2016,S 32ND City of Louisville KY 40211,Structure Fire,118,"118 - Trash or rubbish fire, contained",100,0,100,0,-100
18014,2016,Summer,6/21/2016,S 32ND City of Louisville KY 40211,Structure Fire,118,"118 - Trash or rubbish fire, contained",100,0,100,0,-100
18030,2016,Summer,6/21/2016,S HANCOCK City of Louisville KY 40203,Vehicle Fire,131,131 - Passenger vehicle fire,0,2500,2500,2500,0
18042,2016,Summer,6/21/2016,2220 W OAK n/a City of Louisville KY 40210,Structure Fire,113,"113 - Cooking fire, confined to container",200,0,200,NULL,NULL
18062,2016,Summer,6/21/2016,3661 LENTZ N/A City of Louisville KY 40215,Structure Fire,111,111 - Building fire,3000,8000,11000,65000,54000
18014,2016,Summer,6/21/2016,S 32ND City of Louisville KY 40211,Structure Fire,118,"118 - Trash or rubbish fire, contained",100,0,100,0,-100
18030,2016,Summer,6/21/2016,S HANCOCK City of Louisville KY 40203,Vehicle Fire,131,131 - Passenger vehicle fire,0,2500,2500,2500,0
18042,2016,Summer,6/21/2016,2220 W OAK n/a City of Louisville KY 40210,Structure Fire,113,"113 - Cooking fire, confined to container",200,0,200,NULL,NULL
18030,2016,Summer,6/21/2016,S HANCOCK City of Louisville KY 40203,Vehicle Fire,131,131 - Passenger vehicle fire,0,2500,2500,2500,0
18042,2016,Summer,6/21/2016,2220 W OAK n/a City of Louisville KY 40210,Structure Fire,113,"113 - Cooking fire, confined to container",200,0,200,NULL,NULL
18062,2016,Summer,6/21/2016,3661 LENTZ N/A City of Louisville KY 40215,Structure Fire,111,111 - Building fire,3000,8000,11000,65000,54000
18062,2016,Summer,6/21/2016,3661 LENTZ N/A City of Louisville KY 40215,Structure Fire,111,111 - Building fire,3000,8000,11000,65000,54000
18120,2016,Summer,6/22/2016,203 CORALBERRY N/A City of Beechwood Village KY 40207,Structure Fire,111,111 - Building fire,50000,200000,250000,700000,450000
18128,2016,Summer,6/22/2016,728 S 4TH na City of Louisville KY 40202,Structure Fire,111,111 - Building fire,500,500,1000,500,-500
18145,2016,Summer,6/22/2016,N 24TH City of Louisville KY 40212,Vehicle Fire,131,131 - Passenger vehicle fire,0,4550,4550,4550,0
18120,2016,Summer,6/22/2016,203 CORALBERRY N/A City of Beechwood Village KY 40207,Structure Fire,111,111 - Building fire,50000,200000,250000,700000,450000
18128,2016,Summer,6/22/2016,728 S 4TH na City of Louisville KY 40202,Structure Fire,111,111 - Building fire,500,500,1000,500,-500
18145,2016,Summer,6/22/2016,N 24TH City of Louisville KY 40212,Vehicle Fire,131,131 - Passenger vehicle fire,0,4550,4550,4550,0
18120,2016,Summer,6/22/2016,203 CORALBERRY N/A City of Beechwood Village KY 40207,Structure Fire,111,111 - Building fire,50000,200000,250000,700000,450000
18128,2016,Summer,6/22/2016,728 S 4TH na City of Louisville KY 40202,Structure Fire,111,111 - Building fire,500,500,1000,500,-500
18145,2016,Summer,6/22/2016,N 24TH City of Louisville KY 40212,Vehicle Fire,131,131 - Passenger vehicle fire,0,4550,4550,4550,0
18378,2016,Summer,6/24/2016,4000 TAYLORSVILLE n/a City of Cambridge KY 40220,Vehicle Fire,131,131 - Passenger vehicle fire,0,2500,2500,2500,0
18378,2016,Summer,6/24/2016,4000 TAYLORSVILLE n/a City of Cambridge KY 40220,Vehicle Fire,131,131 - Passenger vehicle fire,0,2500,2500,2500,0
18378,2016,Summer,6/24/2016,4000 TAYLORSVILLE n/a City of Cambridge KY 40220,Vehicle Fire,131,131 - Passenger vehicle fire,0,2500,2500,2500,0
18473,2016,Summer,6/25/2016,1360 BARDSTOWN N/A City of Louisville KY 40204,Vehicle Fire,131,131 - Passenger vehicle fire,0,70000,70000,70000,0
18473,2016,Summer,6/25/2016,1360 BARDSTOWN N/A City of Louisville KY 40204,Vehicle Fire,131,131 - Passenger vehicle fire,0,70000,70000,70000,0
18473,2016,Summer,6/25/2016,1360 BARDSTOWN N/A City of Louisville KY 40204,Vehicle Fire,131,131 - Passenger vehicle fire,0,70000,70000,70000,0
18959,2016,Summer,6/30/2016,1124 FISK N/A City of Louisville KY 40203,Structure Fire,111,111 - Building fire,200,0,200,NULL,NULL
18959,2016,Summer,6/30/2016,1124 FISK N/A City of Louisville KY 40203,Structure Fire,111,111 - Building fire,200,0,200,NULL,NULL
18959,2016,Summer,6/30/2016,1124 FISK N/A City of Louisville KY 40203,Structure Fire,111,111 - Building fire,200,0,200,NULL,NULL
19350,2016,Summer,7/3/2016,TAYLORSVILLE City of Cambridge KY 40220,Vehicle Fire,131,131 - Passenger vehicle fire,0,1000,1000,5000,4000
19369,2016,Summer,7/4/2016,1521 W JEFFERSON N/A City of Louisville KY 40203,Structure Fire,111,111 - Building fire,2500,5000,7500,53940,46440
19401,2016,Summer,7/4/2016,1245 S 7TH 2 City of Louisville KY 40203,Structure Fire,111,111 - Building fire,0,100,100,10000,9900
19406,2016,Summer,7/4/2016,312 SHORT N/A City of Louisville KY 40212,Vehicle Fire,131,131 - Passenger vehicle fire,0,2145,2145,2145,0
19494,2016,Summer,7/5/2016,727 COKE N/A City of Louisville KY 40203,Structure Fire,111,111 - Building fire,0,40000,40000,40000,0
19585,2016,Summer,7/5/2016,W ASHLAND City of Louisville KY 40215,Vehicle Fire,131,131 - Passenger vehicle fire,200,3000,3200,3000,-200
19647,2016,Summer,7/6/2016,I 264 East N/A City of Louisville KY 40209,Vehicle Fire,131,131 - Passenger vehicle fire,0,3000,3000,3500,500
19807,2016,Summer,7/7/2016,3629 GREENWOOD n/a City of Louisville KY 40211,Structure Fire,111,111 - Building fire,15000,30000,45000,50000,5000
19857,2016,Summer,7/8/2016,400 S 8TH 608 City of Louisville KY 40203,Structure Fire,113,"113 - Cooking fire, confined to container",500,500,1000,500,-500
19906,2016,Summer,7/8/2016,205 S PETERSON N/A City of Louisville KY 40206,Structure Fire,111,111 - Building fire,0,2000,2000,579530,577530
19928,2016,Summer,7/8/2016,4418 TAYLOR 30 City of Louisville KY 40215,Structure Fire,111,111 - Building fire,0,1500,1500,1500,0
20022,2016,Summer,7/9/2016,1818 GRAND N/A City of Louisville KY 40210,Vehicle Fire,131,131 - Passenger vehicle fire,0,2000,2000,2000,0
20058,2016,Summer,7/10/2016,1487 FRANKFORT na City of Louisville KY 40206,Vehicle Fire,131,131 - Passenger vehicle fire,0,5000,5000,5000,0
20090,2016,Summer,7/10/2016,1043 S SHELBY 2 City of Louisville KY 40203,Structure Fire,111,111 - Building fire,50,0,50,NULL,NULL
20108,2016,Summer,7/10/2016,660 EASTLAWN N/A City of Louisville KY 40211,Structure Fire,111,111 - Building fire,1000,500,1500,90000,88500
20126,2016,Summer,7/10/2016,520 EASTERN n/a City of Louisville KY 40217,Vehicle Fire,131,131 - Passenger vehicle fire,0,2500,2500,3000,500
20152,2016,Summer,7/10/2016,DIXIE City of Louisville KY 40210,Vehicle Fire,131,131 - Passenger vehicle fire,0,2000,2000,2000,0
20172,2016,Summer,7/11/2016,2126 S 4TH n/a City of Louisville KY 40208,Vehicle Fire,131,131 - Passenger vehicle fire,200,1000,1200,1000,-200
20277,2016,Summer,7/11/2016,1519 S 10TH N/A City of Louisville KY 40210,Vehicle Fire,131,131 - Passenger vehicle fire,300,1500,1800,1500,-300
20351,2016,Summer,7/12/2016,LOTUS City of Audubon Park KY 40213,Vehicle Fire,131,131 - Passenger vehicle fire,0,500,500,2500,2000
20511,2016,Summer,7/14/2016,I 64 East N/A City of Kingsley KY 40205,Vehicle Fire,132,132 - Road freight or transport vehicle fire,0,5000,5000,50000,45000
20578,2016,Summer,7/15/2016,4214 NANEEN na City of Louisville KY 40216,Structure Fire,111,111 - Building fire,800,0,800,NULL,NULL
20652,2016,Summer,7/15/2016,1515 CYPRESS 005 City of Louisville KY 40210,Vehicle Fire,131,131 - Passenger vehicle fire,0,2000,2000,2000,0
20710,2016,Summer,7/16/2016,534 DR W J HODGE N/A City of Louisville KY 40203,Structure Fire,111,111 - Building fire,10000,35000,45000,55000,10000
20722,2016,Summer,7/16/2016,I 264 East City of Louisville KY 40211,Vehicle Fire,131,131 - Passenger vehicle fire,0,5000,5000,5000,0
20757,2016,Summer,7/16/2016,I 264 West N/A City of Bancroft KY 40222,Vehicle Fire,131,131 - Passenger vehicle fire,0,5000,5000,5000,0
20815,2016,Summer,7/17/2016,1609 BLUEGRASS N/A City of Louisville KY 40215,Structure Fire,111,111 - Building fire,30000,85000,115000,96000,-19000
20880,2016,Summer,7/17/2016,I 264 West n/a City of Kingsley KY 40205,Vehicle Fire,131,131 - Passenger vehicle fire,0,6000,6000,6000,0
20942,2016,Summer,7/18/2016,1119 CARLISLE N/A City of Louisville KY 40215,Vehicle Fire,131,131 - Passenger vehicle fire,50,1200,1250,1200,-50
21009,2016,Summer,7/18/2016,4326 POPLAR LEVEL N/A City of Audubon Park KY 40213,Vehicle Fire,131,131 - Passenger vehicle fire,0,2000,2000,2000,0
21190,2016,Summer,7/20/2016,241 S SHAWNEE na City of Louisville KY 40212,Structure Fire,111,111 - Building fire,15000,25000,40000,107440,67440
21198,2016,Summer,7/20/2016,1618 ARLING N/A City of Louisville KY 40215,Structure Fire,111,111 - Building fire,5000,20000,25000,53750,28750
21248,2016,Summer,7/20/2016,1836 GREENWOOD 0 City of Louisville KY 40210,Structure Fire,111,111 - Building fire,0,5,5,27000,26995
21355,2016,Summer,7/21/2016,S 4TH City of Louisville KY 40202,Vehicle Fire,131,131 - Passenger vehicle fire,500,8000,8500,8000,-500
21398,2016,Summer,7/21/2016,4507 CHURCHMAN 7 City of Louisville KY 40215,Structure Fire,111,111 - Building fire,1500,5000,6500,480000,473500
21411,2016,Summer,7/21/2016,1700 ROSEWOOD 3 City of Louisville KY 40204,Structure Fire,111,111 - Building fire,500,2500,3000,2500,-500
21537,2016,Summer,7/22/2016,RUNDILL City of Louisville KY 40214,Vehicle Fire,131,131 - Passenger vehicle fire,0,9000,9000,9000,0
21554,2016,Summer,7/23/2016,207 W BROADWAY n/a City of Louisville KY 40202,Vehicle Fire,131,131 - Passenger vehicle fire,0,500,500,500,0
21609,2016,Summer,7/23/2016,S 41ST City of Louisville KY 40211,Vehicle Fire,131,131 - Passenger vehicle fire,0,4000,4000,4000,0
21687,2016,Summer,7/24/2016,512 Camden n/a City of Louisville KY 40214,Vehicle Fire,131,131 - Passenger vehicle fire,0,2000,2000,2000,0
21699,2016,Summer,7/24/2016,W BROADWAY City of Louisville KY 40211,Vehicle Fire,131,131 - Passenger vehicle fire,500,5000,5500,5000,-500
21752,2016,Summer,7/24/2016,1260 BASSETT N/A City of Louisville KY 40204,Structure Fire,111,111 - Building fire,100000,150000,250000,150000,-100000
21760,2016,Summer,7/24/2016,I 264 East n/a City of Audubon Park KY 40213,Vehicle Fire,131,131 - Passenger vehicle fire,0,8000,8000,8000,0
21752,2016,Summer,7/24/2016,1258 BASSETT N/A City of Louisville KY 40204,Structure Fire,111,111 - Building fire,0,1000,1000,1000,0
21752,2016,Summer,7/24/2016,1256 BASSETT N/A City of Louisville KY 40204,Structure Fire,111,111 - Building fire,0,1500,1500,1500,0
21752,2016,Summer,7/24/2016,1264 BASSETT N/A City of Louisville KY 40204,Structure Fire,111,111 - Building fire,0,500,500,500,0
21752,2016,Summer,7/24/2016,1262 BASSETT N/A City of Louisville KY 40204,Structure Fire,111,111 - Building fire,150000,200000,350000,200000,-150000
21752,2016,Summer,7/24/2016,1260 BASSETT N/A City of Louisville KY 40204,Structure Fire,111,111 - Building fire,100000,150000,250000,150000,-100000
21752,2016,Summer,7/24/2016,1258 BASSETT N/A City of Louisville KY 40204,Structure Fire,111,111 - Building fire,0,1000,1000,1000,0
21752,2016,Summer,7/24/2016,1256 BASSETT N/A City of Louisville KY 40204,Structure Fire,111,111 - Building fire,0,1500,1500,1500,0
21752,2016,Summer,7/24/2016,1264 BASSETT N/A City of Louisville KY 40204,Structure Fire,111,111 - Building fire,0,500,500,500,0
21752,2016,Summer,7/24/2016,1262 BASSETT N/A City of Louisville KY 40204,Structure Fire,111,111 - Building fire,150000,200000,350000,200000,-150000
21878,2016,Summer,7/25/2016,1322 SALE n/a City of Louisville KY 40215,Vehicle Fire,131,131 - Passenger vehicle fire,0,1000,1000,1000,0
21896,2016,Summer,7/25/2016,1158 S 43RD n/a City of Louisville KY 40211,Vehicle Fire,131,131 - Passenger vehicle fire,100,2500,2600,2500,-100
22017,2016,Summer,7/27/2016,1732 GREGG NA City of Louisville KY 40210,Structure Fire,111,111 - Building fire,100,200,300,41000,40700
22103,2016,Summer,7/27/2016,1500 THACKERAY N/A City of Kingsley KY 40205,Structure Fire,111,111 - Building fire,15000,130000,145000,256000,111000
22300,2016,Summer,7/29/2016,914 EUCLID N/A City of Louisville KY 40208,Structure Fire,111,111 - Building fire,1000,1000,2000,5000,3000
22316,2016,Summer,7/29/2016,1402 WILLS N/A City of Louisville KY 40211,Outside Fire,162,162 - Outside equipment fire,0,100,100,100,0
22441,2016,Summer,7/30/2016,1200 DRESDEN N/A City of Louisville KY 40215,Structure Fire,111,111 - Building fire,5000,10000,15000,79480,64480
22469,2016,Summer,7/30/2016,N 30TH City of Louisville KY 40212,Vehicle Fire,131,131 - Passenger vehicle fire,0,4000,4000,4000,0
22661,2016,Autumn,8/1/2016,S BAYLY City of Louisville KY 40206,Vehicle Fire,131,131 - Passenger vehicle fire,0,3000,3000,3500,500
22661,2016,Autumn,8/1/2016,S BAYLY City of Louisville KY 40206,Vehicle Fire,131,131 - Passenger vehicle fire,0,3000,3000,3500,500
22723,2016,Autumn,8/2/2016,409 E MUHAMMAD ALI 807 City of Louisville KY 40202,Structure Fire,113,"113 - Cooking fire, confined to container",700,200,900,200,-700
22740,2016,Autumn,8/2/2016,1016 CEDAR N/A City of Louisville KY 40203,Structure Fire,111,111 - Building fire,300,0,300,0,-300
22723,2016,Autumn,8/2/2016,409 E MUHAMMAD ALI 807 City of Louisville KY 40202,Structure Fire,113,"113 - Cooking fire, confined to container",700,200,900,200,-700
22740,2016,Autumn,8/2/2016,1016 CEDAR N/A City of Louisville KY 40203,Structure Fire,111,111 - Building fire,300,0,300,0,-300
22773,2016,Autumn,8/3/2016,1760 WILSON na City of Louisville KY 40210,Vehicle Fire,131,131 - Passenger vehicle fire,0,5000,5000,5000,0
22819,2016,Autumn,8/3/2016,3017 PENWAY na City of Louisville KY 40210,Structure Fire,111,111 - Building fire,1500,2000,3500,21590,18090
22773,2016,Autumn,8/3/2016,1760 WILSON na City of Louisville KY 40210,Vehicle Fire,131,131 - Passenger vehicle fire,0,5000,5000,5000,0
22819,2016,Autumn,8/3/2016,3017 PENWAY na City of Louisville KY 40210,Structure Fire,111,111 - Building fire,1500,2000,3500,21590,18090
22927,2016,Autumn,8/4/2016,1414 S 4TH 6 City of Louisville KY 40208,Structure Fire,113,"113 - Cooking fire, confined to container",500,0,500,NULL,NULL
22957,2016,Autumn,8/4/2016,1411 S BROOK none City of Louisville KY 40208,Vehicle Fire,131,131 - Passenger vehicle fire,200,5000,5200,5000,-200
22965,2016,Autumn,8/4/2016,1078 E KENTUCKY None City of Louisville KY 40204,Vehicle Fire,131,131 - Passenger vehicle fire,0,500,500,500,0
22965,2016,Autumn,8/4/2016,1078 E KENTUCKY None City of Louisville KY 40204,Vehicle Fire,131,131 - Passenger vehicle fire,0,2000,2000,125000,123000
22927,2016,Autumn,8/4/2016,1414 S 4TH 6 City of Louisville KY 40208,Structure Fire,113,"113 - Cooking fire, confined to container",500,0,500,NULL,NULL
22957,2016,Autumn,8/4/2016,1411 S BROOK none City of Louisville KY 40208,Vehicle Fire,131,131 - Passenger vehicle fire,200,5000,5200,5000,-200
22965,2016,Autumn,8/4/2016,1078 E KENTUCKY None City of Louisville KY 40204,Vehicle Fire,131,131 - Passenger vehicle fire,0,500,500,500,0
22965,2016,Autumn,8/4/2016,1078 E KENTUCKY None City of Louisville KY 40204,Vehicle Fire,131,131 - Passenger vehicle fire,0,2000,2000,125000,123000
23083,2016,Autumn,8/5/2016,1808 WENATCHEE NA City of Louisville KY 40210,Structure Fire,112,112 - Fires in structure other than in a building,25,0,25,0,-25
23083,2016,Autumn,8/5/2016,1808 WENATCHEE NA City of Louisville KY 40210,Structure Fire,112,112 - Fires in structure other than in a building,25,0,25,0,-25
23094,2016,Autumn,8/6/2016,331 E ST CATHERINE n/a City of Louisville KY 40203,Structure Fire,111,111 - Building fire,0,100000,100000,150000,50000
23100,2016,Autumn,8/6/2016,GARLAND City of Louisville KY 40211,Outside Fire,160,"160 - Special outside fire, other",0,200,200,200,0
23094,2016,Autumn,8/6/2016,331 E ST CATHERINE n/a City of Louisville KY 40203,Structure Fire,111,111 - Building fire,0,100000,100000,150000,50000
23100,2016,Autumn,8/6/2016,GARLAND City of Louisville KY 40211,Outside Fire,160,"160 - Special outside fire, other",0,200,200,200,0
23382,2016,Autumn,8/8/2016,863 PARKWAY n/a City of Louisville KY 40217,Structure Fire,111,111 - Building fire,5000,10000,15000,150000,135000
23383,2016,Autumn,8/8/2016,1901 DEER PARK 0 City of Kingsley KY 40205,Structure Fire,111,111 - Building fire,100,100,200,100,-100
23389,2016,Autumn,8/8/2016,1635 PLYMOUTH na City of Louisville KY 40203,Structure Fire,111,111 - Building fire,0,50000,50000,353900,303900
23382,2016,Autumn,8/8/2016,863 PARKWAY n/a City of Louisville KY 40217,Structure Fire,111,111 - Building fire,5000,10000,15000,150000,135000
23383,2016,Autumn,8/8/2016,1901 DEER PARK 0 City of Kingsley KY 40205,Structure Fire,111,111 - Building fire,100,100,200,100,-100
23389,2016,Autumn,8/8/2016,1635 PLYMOUTH na City of Louisville KY 40203,Structure Fire,111,111 - Building fire,0,50000,50000,353900,303900
23471,2016,Autumn,8/9/2016,629 DAVIES n/a City of Louisville KY 40208,Structure Fire,111,111 - Building fire,0,3000,3000,50000,47000
23509,2016,Autumn,8/9/2016,1627 BERRY garage City of Louisville KY 40215,Structure Fire,111,111 - Building fire,500,8000,8500,8000,-500
23471,2016,Autumn,8/9/2016,629 DAVIES n/a City of Louisville KY 40208,Structure Fire,111,111 - Building fire,0,3000,3000,50000,47000
23509,2016,Autumn,8/9/2016,1627 BERRY garage City of Louisville KY 40215,Structure Fire,111,111 - Building fire,500,8000,8500,8000,-500
23517,2016,Autumn,8/10/2016,3118 RIVER PARK na City of Louisville KY 40211,Vehicle Fire,131,131 - Passenger vehicle fire,2000,2000,4000,2000,-2000
23517,2016,Autumn,8/10/2016,3118 RIVER PARK na City of Louisville KY 40211,Vehicle Fire,131,131 - Passenger vehicle fire,2000,2000,4000,2000,-2000
23654,2016,Autumn,8/11/2016,I 264 West N/A City of Louisville KY 40211,Vehicle Fire,131,131 - Passenger vehicle fire,0,6000,6000,6000,0
23685,2016,Autumn,8/11/2016,3212 HALE N/A City of Louisville KY 40211,Structure Fire,113,"113 - Cooking fire, confined to container",1000,1000,2000,1000,-1000
23654,2016,Autumn,8/11/2016,I 264 West N/A City of Louisville KY 40211,Vehicle Fire,131,131 - Passenger vehicle fire,0,6000,6000,6000,0
23685,2016,Autumn,8/11/2016,3212 HALE N/A City of Louisville KY 40211,Structure Fire,113,"113 - Cooking fire, confined to container",1000,1000,2000,1000,-1000
23745,2016,Autumn,8/12/2016,I 65 North NA City of Audubon Park KY 40213,Vehicle Fire,132,132 - Road freight or transport vehicle fire,0,1000,1000,15000,14000
23745,2016,Autumn,8/12/2016,I 65 North NA City of Audubon Park KY 40213,Vehicle Fire,132,132 - Road freight or transport vehicle fire,0,1000,1000,15000,14000
23986,2016,Autumn,8/14/2016,820 W WHITNEY na City of Louisville KY 40215,Vehicle Fire,131,131 - Passenger vehicle fire,1000,3500,4500,3500,-1000
24025,2016,Autumn,8/14/2016,819 W WHITNEY 0 City of Louisville KY 40215,Vehicle Fire,131,131 - Passenger vehicle fire,0,50,50,1000,950
23986,2016,Autumn,8/14/2016,820 W WHITNEY na City of Louisville KY 40215,Vehicle Fire,131,131 - Passenger vehicle fire,1000,3500,4500,3500,-1000
24025,2016,Autumn,8/14/2016,819 W WHITNEY 0 City of Louisville KY 40215,Vehicle Fire,131,131 - Passenger vehicle fire,0,50,50,1000,950
24137,2016,Autumn,8/15/2016,1744 S 13TH E City of Louisville KY 40210,Structure Fire,111,111 - Building fire,500,0,500,0,-500
24137,2016,Autumn,8/15/2016,1744 S 13TH E City of Louisville KY 40210,Structure Fire,111,111 - Building fire,500,0,500,0,-500
24182,2016,Autumn,8/16/2016,1027 S 7TH n/a City of Louisville KY 40203,Vehicle Fire,131,131 - Passenger vehicle fire,0,5000,5000,10000,5000
24182,2016,Autumn,8/16/2016,1027 S 7TH n/a City of Louisville KY 40203,Vehicle Fire,131,131 - Passenger vehicle fire,0,5000,5000,10000,5000
24239,2016,Autumn,8/16/2016,921 CECIL N/A City of Louisville KY 40211,Structure Fire,113,"113 - Cooking fire, confined to container",1200,200,1400,60500,59100
24239,2016,Autumn,8/16/2016,921 CECIL N/A City of Louisville KY 40211,Structure Fire,113,"113 - Cooking fire, confined to container",1200,200,1400,60500,59100
24388,2016,Autumn,8/18/2016,S BROOK City of Louisville KY 40203,Vehicle Fire,131,131 - Passenger vehicle fire,100,500,600,500,-100
24401,2016,Autumn,8/18/2016,3638 RIVER PARK N/A City of Louisville KY 40211,Structure Fire,111,111 - Building fire,0,5000,5000,42110,37110
24464,2016,Autumn,8/18/2016,1017 SAMUEL N/A City of Louisville KY 40204,Structure Fire,111,111 - Building fire,0,100,100,50000,49900
24464,2016,Autumn,8/18/2016,1017 SAMUEL N/A City of Louisville KY 40204,Structure Fire,111,111 - Building fire,0,100,100,50000,49900
24388,2016,Autumn,8/18/2016,S BROOK City of Louisville KY 40203,Vehicle Fire,131,131 - Passenger vehicle fire,100,500,600,500,-100
24401,2016,Autumn,8/18/2016,3638 RIVER PARK N/A City of Louisville KY 40211,Structure Fire,111,111 - Building fire,0,5000,5000,42110,37110
24586,2016,Autumn,8/19/2016,200 ABRAHAM FLEXNER n/a City of Louisville KY 40202,Structure Fire,113,"113 - Cooking fire, confined to container",0,5000,5000,5000,0
24586,2016,Autumn,8/19/2016,200 ABRAHAM FLEXNER n/a City of Louisville KY 40202,Structure Fire,113,"113 - Cooking fire, confined to container",0,5000,5000,5000,0
24657,2016,Autumn,8/20/2016,1114 S 4TH na City of Louisville KY 40203,Vehicle Fire,131,131 - Passenger vehicle fire,0,5000,5000,5000,0
24668,2016,Autumn,8/20/2016,4030 TAYLOR 2 City of Louisville KY 40215,Structure Fire,111,111 - Building fire,10000,15000,25000,75000,50000
24657,2016,Autumn,8/20/2016,1114 S 4TH na City of Louisville KY 40203,Vehicle Fire,131,131 - Passenger vehicle fire,0,5000,5000,5000,0
24668,2016,Autumn,8/20/2016,4030 TAYLOR 2 City of Louisville KY 40215,Structure Fire,111,111 - Building fire,10000,15000,25000,75000,50000
24753,2016,Autumn,8/21/2016,2600 W BROADWAY 406 City of Louisville KY 40211,Structure Fire,111,111 - Building fire,150,0,150,NULL,NULL
24762,2016,Autumn,8/21/2016,2619 S 6TH na City of Louisville KY 40208,Structure Fire,111,111 - Building fire,1000,1000,2000,55640,53640
24783,2016,Autumn,8/21/2016,923 MARY n/a City of Louisville KY 40204,Vehicle Fire,131,131 - Passenger vehicle fire,0,3000,3000,3000,0
24753,2016,Autumn,8/21/2016,2600 W BROADWAY 406 City of Louisville KY 40211,Structure Fire,111,111 - Building fire,150,0,150,NULL,NULL
24762,2016,Autumn,8/21/2016,2619 S 6TH na City of Louisville KY 40208,Structure Fire,111,111 - Building fire,1000,1000,2000,55640,53640
24783,2016,Autumn,8/21/2016,923 MARY n/a City of Louisville KY 40204,Vehicle Fire,131,131 - Passenger vehicle fire,0,3000,3000,3000,0
24884,2016,Autumn,8/22/2016,2113 MAGAZINE 4 City of Louisville KY 40211,Structure Fire,113,"113 - Cooking fire, confined to container",100,0,100,0,-100
24884,2016,Autumn,8/22/2016,2113 MAGAZINE 4 City of Louisville KY 40211,Structure Fire,113,"113 - Cooking fire, confined to container",100,0,100,0,-100
24917,2016,Autumn,8/23/2016,3517 W MUHAMMAD ALI na City of Louisville KY 40212,Vehicle Fire,131,131 - Passenger vehicle fire,0,10000,10000,10000,0
24961,2016,Autumn,8/23/2016,3421 W BROADWAY NA City of Louisville KY 40211,Vehicle Fire,131,131 - Passenger vehicle fire,50,300,350,500,150
25000,2016,Autumn,8/23/2016,S 4TH City of Louisville KY 40208,Vehicle Fire,131,131 - Passenger vehicle fire,0,1500,1500,1500,0
24917,2016,Autumn,8/23/2016,3517 W MUHAMMAD ALI na City of Louisville KY 40212,Vehicle Fire,131,131 - Passenger vehicle fire,0,10000,10000,10000,0
24961,2016,Autumn,8/23/2016,3421 W BROADWAY NA City of Louisville KY 40211,Vehicle Fire,131,131 - Passenger vehicle fire,50,300,350,500,150
25000,2016,Autumn,8/23/2016,S 4TH City of Louisville KY 40208,Vehicle Fire,131,131 - Passenger vehicle fire,0,1500,1500,1500,0
25005,2016,Autumn,8/24/2016,818 ASH N/A City of Louisville KY 40217,Structure Fire,111,111 - Building fire,20000,108820,128820,108820,-20000
25005,2016,Autumn,8/24/2016,816 ASH N/A City of Louisville KY 40217,Structure Fire,111,111 - Building fire,5000,35000,40000,135880,95880
25005,2016,Autumn,8/24/2016,820 ASH N/A City of Louisville KY 40217,Structure Fire,111,111 - Building fire,0,5000,5000,112790,107790
25005,2016,Autumn,8/24/2016,818 ASH N/A City of Louisville KY 40217,Structure Fire,111,111 - Building fire,20000,108820,128820,108820,-20000
25067,2016,Autumn,8/24/2016,1136 EUCLID kitchen City of Louisville KY 40208,Structure Fire,111,111 - Building fire,1000,2000,3000,42340,39340
25005,2016,Autumn,8/24/2016,816 ASH N/A City of Louisville KY 40217,Structure Fire,111,111 - Building fire,5000,35000,40000,135880,95880
25005,2016,Autumn,8/24/2016,820 ASH N/A City of Louisville KY 40217,Structure Fire,111,111 - Building fire,0,5000,5000,112790,107790
25067,2016,Autumn,8/24/2016,1136 EUCLID kitchen City of Louisville KY 40208,Structure Fire,111,111 - Building fire,1000,2000,3000,42340,39340
25254,2016,Autumn,8/26/2016,1518 ARLING n/a City of Louisville KY 40215,Vehicle Fire,131,131 - Passenger vehicle fire,0,3000,3000,3000,0
25286,2016,Autumn,8/26/2016,I 264 West City of Louisville KY 40209,Vehicle Fire,131,131 - Passenger vehicle fire,0,3000,3000,3000,0
25325,2016,Autumn,8/26/2016,1809 BANK NA City of Louisville KY 40203,Structure Fire,111,111 - Building fire,1000,500,1500,88300,86800
25254,2016,Autumn,8/26/2016,1518 ARLING n/a City of Louisville KY 40215,Vehicle Fire,131,131 - Passenger vehicle fire,0,3000,3000,3000,0
25286,2016,Autumn,8/26/2016,I 264 West City of Louisville KY 40209,Vehicle Fire,131,131 - Passenger vehicle fire,0,3000,3000,3000,0
25325,2016,Autumn,8/26/2016,1809 BANK NA City of Louisville KY 40203,Structure Fire,111,111 - Building fire,1000,500,1500,88300,86800
25516,2016,Autumn,8/28/2016,3303 BOHANNON laundry room City of Louisville KY 40215,Structure Fire,111,111 - Building fire,1000,1000,2000,43440,41440
25516,2016,Autumn,8/28/2016,3303 BOHANNON laundry room City of Louisville KY 40215,Structure Fire,111,111 - Building fire,1000,1000,2000,43440,41440
25577,2016,Autumn,8/29/2016,118 S 38TH na City of Louisville KY 40212,Vehicle Fire,131,131 - Passenger vehicle fire,0,11500,11500,11500,0
25577,2016,Autumn,8/29/2016,118 S 38TH na City of Louisville KY 40212,Vehicle Fire,131,131 - Passenger vehicle fire,0,11500,11500,11500,0
25630,2016,Autumn,8/29/2016,735 EASTERN 110 City of Louisville KY 40217,Structure Fire,111,111 - Building fire,2000,5000,7000,2798590,2791590
25630,2016,Autumn,8/29/2016,735 EASTERN 110 City of Louisville KY 40217,Structure Fire,111,111 - Building fire,2000,5000,7000,2798590,2791590
25706,2016,Autumn,8/30/2016,S 2ND City of Louisville KY 40203,Structure Fire,111,111 - Building fire,1000,1000,2000,1000,-1000
25739,2016,Autumn,8/30/2016,2711 BANK na City of Louisville KY 40212,Structure Fire,111,111 - Building fire,500,2000,2500,2000,-500
25706,2016,Autumn,8/30/2016,S 2ND City of Louisville KY 40203,Structure Fire,111,111 - Building fire,1000,1000,2000,1000,-1000
25739,2016,Autumn,8/30/2016,2711 BANK na City of Louisville KY 40212,Structure Fire,111,111 - Building fire,500,2000,2500,2000,-500
25946,2016,Autumn,9/1/2016,1722 FRANKFORT N/A City of Louisville KY 40206,Vehicle Fire,131,131 - Passenger vehicle fire,0,1000,1000,3000,2000
25946,2016,Autumn,9/1/2016,1722 FRANKFORT N/A City of Louisville KY 40206,Vehicle Fire,131,131 - Passenger vehicle fire,0,1000,1000,3000,2000
26040,2016,Autumn,9/2/2016,3600 LARKWOOD na City of Louisville KY 40212,Structure Fire,111,111 - Building fire,25000,20000,45000,40850,-4150
26052,2016,Autumn,9/2/2016,2502 CONCORD front room City of Louisville KY 40217,Structure Fire,111,111 - Building fire,10000,30000,40000,72130,32130
26040,2016,Autumn,9/2/2016,3600 LARKWOOD na City of Louisville KY 40212,Structure Fire,111,111 - Building fire,25000,20000,45000,40850,-4150
26052,2016,Autumn,9/2/2016,2502 CONCORD front room City of Louisville KY 40217,Structure Fire,111,111 - Building fire,10000,30000,40000,72130,32130
26139,2016,Autumn,9/3/2016,2739 S 28TH 0 City of Louisville KY 40212,Vehicle Fire,131,131 - Passenger vehicle fire,0,4510,4510,4510,0
26139,2016,Autumn,9/3/2016,2739 S 28TH 0 City of Louisville KY 40212,Vehicle Fire,131,131 - Passenger vehicle fire,0,4510,4510,4510,0
26239,2016,Autumn,9/4/2016,110 W BRECKINRIDGE 203 City of Louisville KY 40203,Structure Fire,113,"113 - Cooking fire, confined to container",0,300,300,500,200
26314,2016,Autumn,9/4/2016,3715 BRIARBRIDGE n/a City of Louisville KY 40218,Structure Fire,111,111 - Building fire,0,100,100,175000,174900
26239,2016,Autumn,9/4/2016,110 W BRECKINRIDGE 203 City of Louisville KY 40203,Structure Fire,113,"113 - Cooking fire, confined to container",0,300,300,500,200
26314,2016,Autumn,9/4/2016,3715 BRIARBRIDGE n/a City of Louisville KY 40218,Structure Fire,111,111 - Building fire,0,100,100,175000,174900
26481,2016,Autumn,9/6/2016,517 E JEFFERSON 0 City of Louisville KY 40202,Vehicle Fire,131,131 - Passenger vehicle fire,50,1000,1050,20000,18950
26484,2016,Autumn,9/6/2016,1802 W OAK n/a City of Louisville KY 40210,Vehicle Fire,131,131 - Passenger vehicle fire,0,1000,1000,1000,0
26506,2016,Autumn,9/6/2016,3510 DUMESNIL na City of Louisville KY 40211,Vehicle Fire,131,131 - Passenger vehicle fire,0,4000,4000,4000,0
26541,2016,Autumn,9/6/2016,1400 CATALPA 2 City of Louisville KY 40211,Structure Fire,113,"113 - Cooking fire, confined to container",2000,2000,4000,2000,-2000
26481,2016,Autumn,9/6/2016,517 E JEFFERSON 0 City of Louisville KY 40202,Vehicle Fire,131,131 - Passenger vehicle fire,50,1000,1050,20000,18950
26484,2016,Autumn,9/6/2016,1802 W OAK n/a City of Louisville KY 40210,Vehicle Fire,131,131 - Passenger vehicle fire,0,1000,1000,1000,0
26506,2016,Autumn,9/6/2016,3510 DUMESNIL na City of Louisville KY 40211,Vehicle Fire,131,131 - Passenger vehicle fire,0,4000,4000,4000,0
26541,2016,Autumn,9/6/2016,1400 CATALPA 2 City of Louisville KY 40211,Structure Fire,113,"113 - Cooking fire, confined to container",2000,2000,4000,2000,-2000
26604,2016,Autumn,9/7/2016,500 S 20TH NA City of Louisville KY 40203,Structure Fire,112,112 - Fires in structure other than in a building,0,10,10,118930,118920
26624,2016,Autumn,9/7/2016,S 18TH City of Louisville KY 40203,Vehicle Fire,131,131 - Passenger vehicle fire,0,6000,6000,6000,0
26604,2016,Autumn,9/7/2016,500 S 20TH NA City of Louisville KY 40203,Structure Fire,112,112 - Fires in structure other than in a building,0,10,10,118930,118920
26624,2016,Autumn,9/7/2016,S 18TH City of Louisville KY 40203,Vehicle Fire,131,131 - Passenger vehicle fire,0,6000,6000,6000,0
26776,2016,Autumn,9/8/2016,160 CORAL na City of Louisville KY 40206,Structure Fire,118,"118 - Trash or rubbish fire, contained",25,100,125,100,-25
26791,2016,Autumn,9/8/2016,S 25TH City of Louisville KY 40210,Vehicle Fire,131,131 - Passenger vehicle fire,0,18000,18000,18000,0
26776,2016,Autumn,9/8/2016,160 CORAL na City of Louisville KY 40206,Structure Fire,118,"118 - Trash or rubbish fire, contained",25,100,125,100,-25
26791,2016,Autumn,9/8/2016,S 25TH City of Louisville KY 40210,Vehicle Fire,131,131 - Passenger vehicle fire,0,18000,18000,18000,0
26809,2016,Autumn,9/9/2016,144 MOHAWK n/a City of Louisville KY 40214,Structure Fire,111,111 - Building fire,1000,1000,2000,85000,83000
26809,2016,Autumn,9/9/2016,144 MOHAWK n/a City of Louisville KY 40214,Structure Fire,111,111 - Building fire,1000,1000,2000,85000,83000
27013,2016,Autumn,9/10/2016,705 CAMDEN n/a City of Louisville KY 40215,Structure Fire,111,111 - Building fire,0,20000,20000,20000,0
27013,2016,Autumn,9/10/2016,705 CAMDEN n/a City of Louisville KY 40215,Structure Fire,111,111 - Building fire,0,20000,20000,20000,0
27062,2016,Autumn,9/11/2016,1832 NORTHWESTERN N/A City of Louisville KY 40203,Structure Fire,111,111 - Building fire,10000,23480,33480,29350,-4130
27062,2016,Autumn,9/11/2016,1830 NORTHWESTERN N/A City of Louisville KY 40203,Structure Fire,111,111 - Building fire,0,3000,3000,30430,27430
27101,2016,Autumn,9/11/2016,1923 S 4TH N/A City of Louisville KY 40208,Structure Fire,113,"113 - Cooking fire, confined to container",3500,0,3500,0,-3500
27131,2016,Autumn,9/11/2016,1745 SONNE na City of Louisville KY 40216,Structure Fire,111,111 - Building fire,0,5000,5000,90000,85000
27062,2016,Autumn,9/11/2016,1832 NORTHWESTERN N/A City of Louisville KY 40203,Structure Fire,111,111 - Building fire,10000,23480,33480,29350,-4130
27062,2016,Autumn,9/11/2016,1830 NORTHWESTERN N/A City of Louisville KY 40203,Structure Fire,111,111 - Building fire,0,3000,3000,30430,27430
27101,2016,Autumn,9/11/2016,1923 S 4TH N/A City of Louisville KY 40208,Structure Fire,113,"113 - Cooking fire, confined to container",3500,0,3500,0,-3500
27131,2016,Autumn,9/11/2016,1745 SONNE na City of Louisville KY 40216,Structure Fire,111,111 - Building fire,0,5000,5000,90000,85000
27375,2016,Autumn,9/13/2016,2204 DEARING 1 City of Louisville KY 40204,Structure Fire,111,111 - Building fire,0,1000,1000,250000,249000
27375,2016,Autumn,9/13/2016,2204 DEARING 1 City of Louisville KY 40204,Structure Fire,111,111 - Building fire,0,1000,1000,250000,249000
27394,2016,Autumn,9/14/2016,2505 BROWNSBORO na City of Louisville KY 40206,Structure Fire,111,111 - Building fire,10000,10000,20000,60000,40000
27394,2016,Autumn,9/14/2016,2505 BROWNSBORO na City of Louisville KY 40206,Structure Fire,111,111 - Building fire,10000,10000,20000,60000,40000
27515,2016,Autumn,9/15/2016,2623 BANK N/A City of Louisville KY 40212,Structure Fire,111,111 - Building fire,0,250,250,35000,34750
27607,2016,Autumn,9/15/2016,121 HARLAN na City of Louisville KY 40214,Structure Fire,111,111 - Building fire,1000,5000,6000,5000,-1000
27515,2016,Autumn,9/15/2016,2623 BANK N/A City of Louisville KY 40212,Structure Fire,111,111 - Building fire,0,250,250,35000,34750
27607,2016,Autumn,9/15/2016,121 HARLAN na City of Louisville KY 40214,Structure Fire,111,111 - Building fire,1000,5000,6000,5000,-1000
27702,2016,Autumn,9/17/2016,2915 MONTGOMERY n/a City of Louisville KY 40212,Vehicle Fire,131,131 - Passenger vehicle fire,0,2000,2000,2000,0
27702,2016,Autumn,9/17/2016,2915 MONTGOMERY n/a City of Louisville KY 40212,Vehicle Fire,131,131 - Passenger vehicle fire,0,2000,2000,2000,0
27781,2016,Autumn,9/17/2016,2105 HALE na City of Louisville KY 40210,Structure Fire,111,111 - Building fire,4000,15000,19000,22500,3500
27781,2016,Autumn,9/17/2016,2105 HALE na City of Louisville KY 40210,Structure Fire,111,111 - Building fire,4000,15000,19000,22500,3500
27870,2016,Autumn,9/18/2016,817 S 36TH 0 City of Louisville KY 40211,Structure Fire,111,111 - Building fire,0,8000,8000,60000,52000
27870,2016,Autumn,9/18/2016,817 S 36TH 0 City of Louisville KY 40211,Structure Fire,111,111 - Building fire,0,8000,8000,60000,52000
27890,2016,Autumn,9/19/2016,1830 S 3RD n/a City of Louisville KY 40208,Structure Fire,118,"118 - Trash or rubbish fire, contained",50,500,550,26825910,26825360
27890,2016,Autumn,9/19/2016,1830 S 3RD n/a City of Louisville KY 40208,Structure Fire,118,"118 - Trash or rubbish fire, contained",50,500,550,26825910,26825360
28045,2016,Autumn,9/20/2016,S 38TH City of Louisville KY 40212,Vehicle Fire,131,131 - Passenger vehicle fire,0,1000,1000,1000,0
28045,2016,Autumn,9/20/2016,S 38TH City of Louisville KY 40212,Vehicle Fire,131,131 - Passenger vehicle fire,0,1000,1000,1000,0
28257,2016,Autumn,9/22/2016,4620 VARBLE N/A City of Louisville KY 40211,Structure Fire,111,111 - Building fire,5000,69950,74950,69950,-5000
28284,2016,Autumn,9/22/2016,ALGONQUIN City of Louisville KY 40211,Vehicle Fire,131,131 - Passenger vehicle fire,0,3000,3000,4000,1000
28257,2016,Autumn,9/22/2016,4620 VARBLE N/A City of Louisville KY 40211,Structure Fire,111,111 - Building fire,0,2000,2000,71390,69390
28257,2016,Autumn,9/22/2016,4620 VARBLE N/A City of Louisville KY 40211,Structure Fire,111,111 - Building fire,5000,69950,74950,69950,-5000
28284,2016,Autumn,9/22/2016,ALGONQUIN City of Louisville KY 40211,Vehicle Fire,131,131 - Passenger vehicle fire,0,3000,3000,4000,1000
28257,2016,Autumn,9/22/2016,4620 VARBLE N/A City of Louisville KY 40211,Structure Fire,111,111 - Building fire,0,2000,2000,71390,69390
28391,2016,Autumn,9/23/2016,1932 GARDINER na City of Kingsley KY 40205,Outside Fire,162,162 - Outside equipment fire,0,3000,3000,3000,0
28391,2016,Autumn,9/23/2016,1932 GARDINER na City of Kingsley KY 40205,Outside Fire,162,162 - Outside equipment fire,0,3000,3000,3000,0
28422,2016,Autumn,9/24/2016,1455 TIN PAN REAR City of Louisville KY 40208,Vehicle Fire,130,"130 - Mobile property (vehicle) fire, other",0,1000,1000,8000,7000
28431,2016,Autumn,9/24/2016,812 HAZEL na City of Louisville KY 40211,Structure Fire,111,111 - Building fire,0,100,100,22840,22740
28455,2016,Autumn,9/24/2016,3674 WOODRUFF None City of Louisville KY 40215,Structure Fire,111,111 - Building fire,500,0,500,0,-500
28422,2016,Autumn,9/24/2016,1455 TIN PAN REAR City of Louisville KY 40208,Vehicle Fire,130,"130 - Mobile property (vehicle) fire, other",0,1000,1000,8000,7000
28431,2016,Autumn,9/24/2016,812 HAZEL na City of Louisville KY 40211,Structure Fire,111,111 - Building fire,0,100,100,22840,22740
28455,2016,Autumn,9/24/2016,3674 WOODRUFF None City of Louisville KY 40215,Structure Fire,111,111 - Building fire,500,0,500,0,-500
28537,2016,Autumn,9/25/2016,997 VINE n/a City of Louisville KY 40204,Structure Fire,111,111 - Building fire,0,2500,2500,2500,0
28556,2016,Autumn,9/25/2016,2320 WOODLAND n/a City of Louisville KY 40210,Structure Fire,111,111 - Building fire,1000,5000,6000,25000,19000
28537,2016,Autumn,9/25/2016,997 VINE n/a City of Louisville KY 40204,Structure Fire,111,111 - Building fire,0,2500,2500,2500,0
28556,2016,Autumn,9/25/2016,2320 WOODLAND n/a City of Louisville KY 40210,Structure Fire,111,111 - Building fire,1000,5000,6000,25000,19000
28667,2016,Autumn,9/26/2016,W MAIN City of Louisville KY 40202,Vehicle Fire,131,131 - Passenger vehicle fire,300,2000,2300,2000,-300
28681,2016,Autumn,9/26/2016,946 S 25TH na City of Louisville KY 40210,Vehicle Fire,131,131 - Passenger vehicle fire,0,1000,1000,1500,500
28695,2016,Autumn,9/26/2016,I 264 West N/A City of Audubon Park KY 40213,Vehicle Fire,131,131 - Passenger vehicle fire,200,1500,1700,1500,-200
28667,2016,Autumn,9/26/2016,W MAIN City of Louisville KY 40202,Vehicle Fire,131,131 - Passenger vehicle fire,300,2000,2300,2000,-300
28681,2016,Autumn,9/26/2016,946 S 25TH na City of Louisville KY 40210,Vehicle Fire,131,131 - Passenger vehicle fire,0,1000,1000,1500,500
28695,2016,Autumn,9/26/2016,I 264 West N/A City of Audubon Park KY 40213,Vehicle Fire,131,131 - Passenger vehicle fire,200,1500,1700,1500,-200
28784,2016,Autumn,9/27/2016,1122 EVERETT n/a City of Louisville KY 40204,Structure Fire,111,111 - Building fire,0,2500,2500,200000,197500
28799,2016,Autumn,9/27/2016,519 E JEFFERSON 203 City of Louisville KY 40202,Structure Fire,111,111 - Building fire,2000,4000,6000,200000,194000
28784,2016,Autumn,9/27/2016,1122 EVERETT n/a City of Louisville KY 40204,Structure Fire,111,111 - Building fire,0,2500,2500,200000,197500
28799,2016,Autumn,9/27/2016,519 E JEFFERSON 203 City of Louisville KY 40202,Structure Fire,111,111 - Building fire,2000,4000,6000,200000,194000
28824,2016,Autumn,9/28/2016,1323 LONGFIELD none City of Louisville KY 40215,Structure Fire,111,111 - Building fire,0,20000,20000,60000,40000
28824,2016,Autumn,9/28/2016,1325 LONGFIELD none City of Louisville KY 40215,Structure Fire,111,111 - Building fire,0,1000,1000,60000,59000
28824,2016,Autumn,9/28/2016,1323 LONGFIELD none City of Louisville KY 40215,Structure Fire,111,111 - Building fire,0,20000,20000,60000,40000
28824,2016,Autumn,9/28/2016,1325 LONGFIELD none City of Louisville KY 40215,Structure Fire,111,111 - Building fire,0,1000,1000,60000,59000
29154,2016,Autumn,10/1/2016,3820 W MARKET na City of Louisville KY 40212,FALSE,412,412 - Gas leak (natural gas or LPG),0,1000,1000,25000,24000
29454,2016,Autumn,10/4/2016,4034 CHURCHMAN na City of Louisville KY 40215,Structure Fire,111,111 - Building fire,300,0,300,NULL,NULL
29497,2016,Autumn,10/4/2016,3534 LEITH 3 City of Louisville KY 40218,FALSE,743,"743 - Smoke detector activation, no fire - unintentional",0,400,400,200000,199600
29560,2016,Autumn,10/5/2016,419 N 22ND na City of Louisville KY 40212,Structure Fire,111,111 - Building fire,1000,12000,13000,20350,7350
29576,2016,Autumn,10/5/2016,600 TERMINAL 0 City of Louisville KY 40209,Vehicle Fire,135,135 - Aircraft fire,500,500,1000,500,-500
29653,2016,Autumn,10/6/2016,RIVER PARK n/a City of Louisville KY 40211,Vehicle Fire,131,131 - Passenger vehicle fire,0,3000,3000,7000,4000
29648,2016,Autumn,10/6/2016,1830 E MADISON 0 City of Louisville KY 40203,Vehicle Fire,131,131 - Passenger vehicle fire,0,8000,8000,10000,2000
29786,2016,Autumn,10/7/2016,400 S 8TH na City of Louisville KY 40203,Structure Fire,111,111 - Building fire,3000,5000,8000,10000000,9992000
29851,2016,Autumn,10/8/2016,1012 SEELBACH n/a City of Louisville KY 40215,Structure Fire,111,111 - Building fire,5000,55330,60330,55330,-5000
29851,2016,Autumn,10/8/2016,1012 SEELBACH n/a City of Louisville KY 40215,Structure Fire,111,111 - Building fire,0,2000,2000,59000,57000
29971,2016,Autumn,10/9/2016,3706 KLONDIKE 27 City of Louisville KY 40218,Structure Fire,111,111 - Building fire,7000,18000,25000,1399410,1374410
30074,2016,Autumn,10/10/2016,I 264 East n/a City of Louisville KY 40218,Vehicle Fire,131,131 - Passenger vehicle fire,0,1000,1000,1000,0
30118,2016,Autumn,10/10/2016,915 CECIL na City of Louisville KY 40211,Vehicle Fire,131,131 - Passenger vehicle fire,0,4000,4000,4000,0
30328,2016,Autumn,10/12/2016,2903 NARRAGANSETT none City of Louisville KY 40210,Structure Fire,111,111 - Building fire,0,10000,10000,60000,50000
30570,2016,Autumn,10/14/2016,928 W JEFFERSON na City of Louisville KY 40202,Structure Fire,111,111 - Building fire,1000,500,1500,20000,18500
30539,2016,Autumn,10/14/2016,2221 BOLLING n/a City of Louisville KY 40210,Structure Fire,111,111 - Building fire,0,1000,1000,32870,31870
30719,2016,Autumn,10/16/2016,105 S 29TH N/A City of Louisville KY 40212,Structure Fire,111,111 - Building fire,10000,20000,30000,20000,-10000
30718,2016,Autumn,10/16/2016,2704 W MARKET N/A City of Louisville KY 40212,Structure Fire,111,111 - Building fire,1000,15000,16000,15000,-1000
30898,2016,Autumn,10/17/2016,139 E KINGSTON N/A City of Louisville KY 40214,Vehicle Fire,131,131 - Passenger vehicle fire,0,4000,4000,4000,0
30913,2016,Autumn,10/18/2016,407 W SOUTHSIDE n/a City of Louisville KY 40214,Structure Fire,111,111 - Building fire,1000,10000,11000,92730,81730
30910,2016,Autumn,10/18/2016,630 ERVAY basement City of Louisville KY 40217,FALSE,251,"251 - Excessive heat, scorch burns with no ignition",400,0,400,0,-400
31061,2016,Autumn,10/19/2016,5342 MITSCHER n/a City of Louisville KY 40214,Structure Fire,111,111 - Building fire,500,5000,5500,7872420,7866920
31063,2016,Autumn,10/19/2016,W MUHAMMAD ALI City of Louisville KY 40203,Outside Fire,150,"150 - Outside rubbish fire, other",0,2500,2500,2500,0
31191,2016,Autumn,10/20/2016,3061 GRAND 3061 City of Louisville KY 40211,Structure Fire,111,111 - Building fire,0,500,500,212480,211980
31197,2016,Autumn,10/20/2016,407 REG SMITH Building E City of Louisville KY 40208,Structure Fire,111,111 - Building fire,0,1000,1000,1000000,999000
31456,2016,Autumn,10/23/2016,1416 BERRY na City of Louisville KY 40215,Outside Fire,142,142 - Brush or brush-and-grass mixture fire,0,100,100,200,100
31580,2016,Autumn,10/25/2016,316 S 4TH 100 City of Louisville KY 40202,Structure Fire,111,111 - Building fire,5000,2000,7000,9325000,9318000
31700,2016,Autumn,10/26/2016,511 S 5TH n/a City of Louisville KY 40202,Structure Fire,111,111 - Building fire,0,50,50,50,0
31740,2016,Autumn,10/26/2016,2110 STANDARD na City of Louisville KY 40210,Outside Fire,142,142 - Brush or brush-and-grass mixture fire,0,50,50,200,150
31713,2016,Autumn,10/26/2016,132 FRANCIS n/a City of Louisville KY 40214,Structure Fire,111,111 - Building fire,20000,30000,50000,83780,33780
31728,2016,Autumn,10/26/2016,935 BEECHER na City of Louisville KY 40215,Outside Fire,160,"160 - Special outside fire, other",0,200,200,1000,800
31861,2016,Autumn,10/28/2016,3340 DUVALLE N/A City of Louisville KY 40211,Structure Fire,111,111 - Building fire,2000,7500,9500,25000,15500
31892,2016,Autumn,10/28/2016,N 19TH City of Louisville KY 40203,Vehicle Fire,131,131 - Passenger vehicle fire,0,3375,3375,3375,0
31923,2016,Autumn,10/28/2016,E JEFFERSON City of Louisville KY 40202,Vehicle Fire,132,132 - Road freight or transport vehicle fire,0,1000,1000,1000,0
31967,2016,Autumn,10/29/2016,4700 W BROADWAY na City of Louisville KY 40211,Structure Fire,111,111 - Building fire,400,200,600,110470,109870
32036,2016,Autumn,10/29/2016,1007 EUCLID outside City of Louisville KY 40208,Outside Fire,150,"150 - Outside rubbish fire, other",0,300,300,500,200
32061,2016,Autumn,10/30/2016,1915 LYTLE N/A City of Louisville KY 40203,Structure Fire,111,111 - Building fire,1000,5000,6000,5000,-1000
32076,2016,Autumn,10/30/2016,2407 W MUHAMMAD ALI N/A City of Louisville KY 40212,Vehicle Fire,131,131 - Passenger vehicle fire,0,2880,2880,2880,0
32097,2016,Autumn,10/30/2016,NEWBURG City of Kingsley KY 40205,Vehicle Fire,131,131 - Passenger vehicle fire,100,1000,1100,1000,-100
32216,2016,Autumn,10/31/2016,1212 HOMEVIEW n/a City of Louisville KY 40215,Structure Fire,111,111 - Building fire,500,1000,1500,41840,40340
32531,2016,Winter,11/3/2016,BELLS City of Louisville KY 40211,Vehicle Fire,131,131 - Passenger vehicle fire,0,3000,3000,3000,0
32659,2016,Winter,11/5/2016,CECIL City of Louisville KY 40211,Vehicle Fire,131,131 - Passenger vehicle fire,0,2500,2500,2500,0
32664,2016,Winter,11/5/2016,2020 PEABODY 14 City of Louisville KY 40218,Structure Fire,111,111 - Building fire,0,500,500,50000,49500
32668,2016,Winter,11/5/2016,2718 S 6TH n/a City of Louisville KY 40208,Vehicle Fire,131,131 - Passenger vehicle fire,100,4200,4300,4200,-100
32925,2016,Winter,11/7/2016,S 2ND City of Louisville KY 40208,Vehicle Fire,131,131 - Passenger vehicle fire,0,4000,4000,4000,0
32951,2016,Winter,11/8/2016,939 W EVELYN kitchen City of Louisville KY 40215,Structure Fire,111,111 - Building fire,10000,10000,20000,33500,13500
32956,2016,Winter,11/8/2016,2018 PEABODY 7 City of Louisville KY 40218,Structure Fire,111,111 - Building fire,0,500,500,100000,99500
32987,2016,Winter,11/8/2016,5105 Southside 2 City of Louisville KY 40214,Structure Fire,112,112 - Fires in structure other than in a building,0,200,200,500000,499800
33039,2016,Winter,11/8/2016,SOUTHSIDE City of Louisville KY 40214,FALSE,460,"460 - Accident, potential accident, other",0,5000,5000,15000,10000
33058,2016,Winter,11/9/2016,GILLETTE City of Louisville KY 40209,Vehicle Fire,131,131 - Passenger vehicle fire,0,3500,3500,3500,0
33069,2016,Winter,11/9/2016,3714 KAHLERT n/a City of Louisville KY 40215,Outside Fire,154,154 - Dumpster or other outside trash receptacle fire,0,500,500,2000,1500
33335,2016,Winter,11/11/2016,3902 WEWOKA N/A City of Louisville KY 40212,Structure Fire,111,111 - Building fire,5000,14000,19000,14000,-5000
33538,2016,Winter,11/13/2016,4506 HAZELWOOD na City of Louisville KY 40214,Outside Fire,154,154 - Dumpster or other outside trash receptacle fire,0,100,100,100,0
33478,2016,Winter,11/13/2016,3427 HALE na City of Louisville KY 40211,Structure Fire,111,111 - Building fire,2500,15000,17500,21115,3615
33528,2016,Winter,11/13/2016,653 S 39TH na City of Louisville KY 40211,Structure Fire,111,111 - Building fire,100,1000,1100,3000,1900
33532,2016,Winter,11/13/2016,1925 DUKER N/A City of Kingsley KY 40205,Structure Fire,111,111 - Building fire,10000,30000,40000,115000,75000
33538,2016,Winter,11/13/2016,4506 HAZELWOOD na City of Louisville KY 40214,Outside Fire,154,154 - Dumpster or other outside trash receptacle fire,0,100,100,100,0
33627,2016,Winter,11/14/2016,1105 W ASHLAND n/a City of Louisville KY 40215,Structure Fire,113,"113 - Cooking fire, confined to container",500,500,1000,500,-500
33648,2016,Winter,11/15/2016,810 S 35TH N/A City of Louisville KY 40211,Structure Fire,111,111 - Building fire,5000,10000,15000,28900,13900
33648,2016,Winter,11/15/2016,810 S 35TH N/A City of Louisville KY 40211,Structure Fire,111,111 - Building fire,5000,10000,15000,28900,13900
33767,2016,Winter,11/16/2016,909 S 32ND N/A City of Louisville KY 40211,Structure Fire,111,111 - Building fire,0,2000,2000,25030,23030
33835,2016,Winter,11/16/2016,711 CREEL bathroom City of Louisville KY 40208,Structure Fire,111,111 - Building fire,1000,2500,3500,37720,34220
33838,2016,Winter,11/16/2016,ROY WILKINS City of Louisville KY 40203,Vehicle Fire,131,131 - Passenger vehicle fire,0,2600,2600,2600,0
33867,2016,Winter,11/16/2016,CECIL City of Louisville KY 40211,Vehicle Fire,131,131 - Passenger vehicle fire,0,8000,8000,8000,0
33767,2016,Winter,11/16/2016,909 S 32ND N/A City of Louisville KY 40211,Structure Fire,111,111 - Building fire,0,2000,2000,25030,23030
33835,2016,Winter,11/16/2016,711 CREEL bathroom City of Louisville KY 40208,Structure Fire,111,111 - Building fire,1000,2500,3500,37720,34220
33838,2016,Winter,11/16/2016,ROY WILKINS City of Louisville KY 40203,Vehicle Fire,131,131 - Passenger vehicle fire,0,2600,2600,2600,0
33867,2016,Winter,11/16/2016,CECIL City of Louisville KY 40211,Vehicle Fire,131,131 - Passenger vehicle fire,0,8000,8000,8000,0
34018,2016,Winter,11/18/2016,639 E JEFFERSON apt City of Louisville KY 40202,Structure Fire,111,111 - Building fire,0,1500,1500,1500,0
34018,2016,Winter,11/18/2016,639 E JEFFERSON apt City of Louisville KY 40202,Structure Fire,111,111 - Building fire,0,1500,1500,1500,0
34093,2016,Winter,11/19/2016,1616 WILSON Kitchen City of Louisville KY 40210,Structure Fire,111,111 - Building fire,0,10000,10000,30000,20000
34107,2016,Winter,11/19/2016,S 29TH City of Louisville KY 40211,FALSE,352,352 - Extrication of victim(s) from vehicle,0,20000,20000,20000,0
34093,2016,Winter,11/19/2016,1616 WILSON Kitchen City of Louisville KY 40210,Structure Fire,111,111 - Building fire,0,10000,10000,30000,20000
34107,2016,Winter,11/19/2016,S 29TH City of Louisville KY 40211,FALSE,352,352 - Extrication of victim(s) from vehicle,0,20000,20000,20000,0
34177,2016,Winter,11/19/2016,240 GLENDORA na City of Louisville KY 40212,Structure Fire,111,111 - Building fire,5000,20000,25000,40000,15000
34198,2016,Winter,11/19/2016,S 8TH City of Louisville KY 40203,Vehicle Fire,131,131 - Passenger vehicle fire,0,1000,1000,1000,0
34177,2016,Winter,11/19/2016,240 GLENDORA na City of Louisville KY 40212,Structure Fire,111,111 - Building fire,5000,20000,25000,40000,15000
34198,2016,Winter,11/19/2016,S 8TH City of Louisville KY 40203,Vehicle Fire,131,131 - Passenger vehicle fire,0,1000,1000,1000,0
34223,2016,Winter,11/20/2016,710 ROSELANE N/A City of Louisville KY 40203,Vehicle Fire,131,131 - Passenger vehicle fire,0,2000,2000,2000,0
34230,2016,Winter,11/20/2016,2900 7TH STREET n/a City of Louisville KY 40216,Vehicle Fire,138,138 - Off-road vehicle or heavy equipment fire,0,3000,3000,10000,7000
34223,2016,Winter,11/20/2016,710 ROSELANE N/A City of Louisville KY 40203,Vehicle Fire,131,131 - Passenger vehicle fire,0,2000,2000,2000,0
34230,2016,Winter,11/20/2016,2900 7TH STREET n/a City of Louisville KY 40216,Vehicle Fire,138,138 - Off-road vehicle or heavy equipment fire,0,3000,3000,10000,7000
34298,2016,Winter,11/21/2016,1244 S 4TH 424 City of Louisville KY 40203,FALSE,321,"321 - EMS call, excluding vehicle accident with injury",0,50,50,40000,39950
34325,2016,Winter,11/21/2016,937 BEECHER n/a City of Louisville KY 40215,Structure Fire,111,111 - Building fire,800,1500,2300,70000,67700
34350,2016,Winter,11/21/2016,204 W KENWOOD n/a City of Louisville KY 40214,Vehicle Fire,131,131 - Passenger vehicle fire,0,5000,5000,5000,0
34353,2016,Winter,11/21/2016,5434 MITSCHER n/a City of Louisville KY 40214,Structure Fire,111,111 - Building fire,0,200,200,200000,199800
34350,2016,Winter,11/21/2016,204 W KENWOOD n/a City of Louisville KY 40214,Vehicle Fire,131,131 - Passenger vehicle fire,0,5000,5000,5000,0
34353,2016,Winter,11/21/2016,5434 MITSCHER n/a City of Louisville KY 40214,Structure Fire,111,111 - Building fire,0,200,200,200000,199800
34298,2016,Winter,11/21/2016,1244 S 4TH 424 City of Louisville KY 40203,FALSE,321,"321 - EMS call, excluding vehicle accident with injury",0,50,50,40000,39950
34325,2016,Winter,11/21/2016,937 BEECHER n/a City of Louisville KY 40215,Structure Fire,111,111 - Building fire,800,1500,2300,70000,67700
34384,2016,Winter,11/22/2016,S 15TH City of Louisville KY 40210,Vehicle Fire,131,131 - Passenger vehicle fire,0,1500,1500,1500,0
34458,2016,Winter,11/22/2016,2510 ELLIOTT na City of Louisville KY 40211,Outside Fire,142,142 - Brush or brush-and-grass mixture fire,0,50,50,13400,13350
34384,2016,Winter,11/22/2016,S 15TH City of Louisville KY 40210,Vehicle Fire,131,131 - Passenger vehicle fire,0,1500,1500,1500,0
34458,2016,Winter,11/22/2016,2510 ELLIOTT na City of Louisville KY 40211,Outside Fire,142,142 - Brush or brush-and-grass mixture fire,0,50,50,13400,13350
34590,2016,Winter,11/24/2016,217 N 23RD NA City of Louisville KY 40212,FALSE,461,461 - Building or structure weakened or collapsed,0,500,500,18930,18430
34600,2016,Winter,11/24/2016,425 N 28TH NA City of Louisville KY 40212,Vehicle Fire,131,131 - Passenger vehicle fire,1000,3000,4000,3000,-1000
34590,2016,Winter,11/24/2016,217 N 23RD NA City of Louisville KY 40212,FALSE,461,461 - Building or structure weakened or collapsed,0,500,500,18930,18430
34600,2016,Winter,11/24/2016,425 N 28TH NA City of Louisville KY 40212,Vehicle Fire,131,131 - Passenger vehicle fire,1000,3000,4000,3000,-1000
34682,2016,Winter,11/25/2016,2612 DUNCAN NA City of Louisville KY 40212,Structure Fire,111,111 - Building fire,0,200,200,16460,16260
34687,2016,Winter,11/25/2016,630 IROQUOIS n/a City of Louisville KY 40214,Structure Fire,111,111 - Building fire,20000,75000,95000,75000,-20000
34687,2016,Winter,11/25/2016,632 IROQUOIS n/a City of Louisville KY 40214,Structure Fire,111,111 - Building fire,15000,30000,45000,30000,-15000
34687,2016,Winter,11/25/2016,628 IROQUOIS n/a City of Louisville KY 40214,Structure Fire,111,111 - Building fire,0,5000,5000,5000,0
34704,2016,Winter,11/25/2016,2161 EASTVIEW n/a City of Kingsley KY 40205,Structure Fire,111,111 - Building fire,200,1000,1200,252000,250800
34682,2016,Winter,11/25/2016,2612 DUNCAN NA City of Louisville KY 40212,Structure Fire,111,111 - Building fire,0,200,200,16460,16260
34687,2016,Winter,11/25/2016,630 IROQUOIS n/a City of Louisville KY 40214,Structure Fire,111,111 - Building fire,20000,75000,95000,75000,-20000
34687,2016,Winter,11/25/2016,632 IROQUOIS n/a City of Louisville KY 40214,Structure Fire,111,111 - Building fire,15000,30000,45000,30000,-15000
34687,2016,Winter,11/25/2016,628 IROQUOIS n/a City of Louisville KY 40214,Structure Fire,111,111 - Building fire,0,5000,5000,5000,0
34704,2016,Winter,11/25/2016,2161 EASTVIEW n/a City of Kingsley KY 40205,Structure Fire,111,111 - Building fire,200,1000,1200,252000,250800
34758,2016,Winter,11/26/2016,1115 LONGFIELD closet City of Louisville KY 40215,Structure Fire,111,111 - Building fire,1000,5000,6000,49980,43980
34776,2016,Winter,11/26/2016,1900 S FLOYD none City of Louisville KY 40208,Vehicle Fire,131,131 - Passenger vehicle fire,0,2000,2000,2000,0
34758,2016,Winter,11/26/2016,1115 LONGFIELD closet City of Louisville KY 40215,Structure Fire,111,111 - Building fire,1000,5000,6000,49980,43980
34776,2016,Winter,11/26/2016,1900 S FLOYD none City of Louisville KY 40208,Vehicle Fire,131,131 - Passenger vehicle fire,0,2000,2000,2000,0
34855,2016,Winter,11/27/2016,313 S 18TH na City of Louisville KY 40203,Structure Fire,111,111 - Building fire,1000,8000,9000,20000,11000
34865,2016,Winter,11/27/2016,S 25TH City of Louisville KY 40210,Structure Fire,111,111 - Building fire,25000,75000,100000,150000,50000
34898,2016,Winter,11/27/2016,619 INVERNESS Kitchen City of Louisville KY 40214,Structure Fire,111,111 - Building fire,5000,20000,25000,65000,40000
34917,2016,Winter,11/27/2016,723 E ORMSBY N/A City of Louisville KY 40203,Structure Fire,111,111 - Building fire,5000,50000,55000,75000,20000
34855,2016,Winter,11/27/2016,313 S 18TH na City of Louisville KY 40203,Structure Fire,111,111 - Building fire,1000,8000,9000,20000,11000
34865,2016,Winter,11/27/2016,S 25TH City of Louisville KY 40210,Structure Fire,111,111 - Building fire,25000,75000,100000,150000,50000
34898,2016,Winter,11/27/2016,619 INVERNESS Kitchen City of Louisville KY 40214,Structure Fire,111,111 - Building fire,5000,20000,25000,65000,40000
34917,2016,Winter,11/27/2016,723 E ORMSBY N/A City of Louisville KY 40203,Structure Fire,111,111 - Building fire,5000,50000,55000,75000,20000
34917,2016,Winter,11/27/2016,721 E ORMSBY N/A City of Louisville KY 40203,Structure Fire,111,111 - Building fire,0,5000,5000,75000,70000
34917,2016,Winter,11/27/2016,725 E ORMSBY N/A City of Louisville KY 40203,Structure Fire,111,111 - Building fire,0,1000,1000,75000,74000
34917,2016,Winter,11/27/2016,723 E ORMSBY N/A City of Louisville KY 40203,Structure Fire,111,111 - Building fire,5000,5000,10000,100000,90000
34943,2016,Winter,11/27/2016,400 E BROADWAY n/a City of Louisville KY 40202,Outside Fire,150,"150 - Outside rubbish fire, other",0,100,100,100,0
34944,2016,Winter,11/27/2016,5303 ALPINE Garage City of Louisville KY 40214,Structure Fire,111,111 - Building fire,0,1000,1000,8000,7000
34943,2016,Winter,11/27/2016,400 E BROADWAY n/a City of Louisville KY 40202,Outside Fire,150,"150 - Outside rubbish fire, other",0,100,100,100,0
34944,2016,Winter,11/27/2016,5303 ALPINE Garage City of Louisville KY 40214,Structure Fire,111,111 - Building fire,0,1000,1000,8000,7000
34917,2016,Winter,11/27/2016,721 E ORMSBY N/A City of Louisville KY 40203,Structure Fire,111,111 - Building fire,0,5000,5000,75000,70000
34917,2016,Winter,11/27/2016,725 E ORMSBY N/A City of Louisville KY 40203,Structure Fire,111,111 - Building fire,0,1000,1000,75000,74000
34917,2016,Winter,11/27/2016,723 E ORMSBY N/A City of Louisville KY 40203,Structure Fire,111,111 - Building fire,5000,5000,10000,100000,90000
34959,2016,Winter,11/28/2016,723 E ORMSBY N/A City of Louisville KY 40203,Structure Fire,111,111 - Building fire,1,100,101,1000,899
34969,2016,Winter,11/28/2016,610 HARRISON N/A City of Louisville KY 40217,Structure Fire,111,111 - Building fire,10000,30000,40000,150000,110000
34974,2016,Winter,11/28/2016,2539 OWEN NA City of Louisville KY 40212,Structure Fire,111,111 - Building fire,500,10520,11020,10520,-500
35007,2016,Winter,11/28/2016,532 WAINWRIGHT bedroom City of Louisville KY 40217,Structure Fire,111,111 - Building fire,1000,20000,21000,58660,37660
34969,2016,Winter,11/28/2016,612 HARRISON N/A City of Louisville KY 40217,Structure Fire,111,111 - Building fire,1000,1500,2500,180000,177500
34974,2016,Winter,11/28/2016,2539 OWEN NA City of Louisville KY 40212,Structure Fire,111,111 - Building fire,1000,13460,14460,13460,-1000
35007,2016,Winter,11/28/2016,530 WAINWRIGHT adjoining apt City of Louisville KY 40217,Structure Fire,111,111 - Building fire,500,0,500,0,-500
34974,2016,Winter,11/28/2016,2539 OWEN NA City of Louisville KY 40212,Structure Fire,111,111 - Building fire,0,13730,13730,13730,0
34959,2016,Winter,11/28/2016,723 E ORMSBY N/A City of Louisville KY 40203,Structure Fire,111,111 - Building fire,1,100,101,1000,899
34969,2016,Winter,11/28/2016,610 HARRISON N/A City of Louisville KY 40217,Structure Fire,111,111 - Building fire,10000,30000,40000,150000,110000
34969,2016,Winter,11/28/2016,612 HARRISON N/A City of Louisville KY 40217,Structure Fire,111,111 - Building fire,1000,1500,2500,180000,177500
34974,2016,Winter,11/28/2016,2539 OWEN NA City of Louisville KY 40212,Structure Fire,111,111 - Building fire,500,10520,11020,10520,-500
34974,2016,Winter,11/28/2016,2539 OWEN NA City of Louisville KY 40212,Structure Fire,111,111 - Building fire,1000,13460,14460,13460,-1000
34974,2016,Winter,11/28/2016,2539 OWEN NA City of Louisville KY 40212,Structure Fire,111,111 - Building fire,0,13730,13730,13730,0
35007,2016,Winter,11/28/2016,532 WAINWRIGHT bedroom City of Louisville KY 40217,Structure Fire,111,111 - Building fire,1000,20000,21000,58660,37660
35007,2016,Winter,11/28/2016,530 WAINWRIGHT adjoining apt City of Louisville KY 40217,Structure Fire,111,111 - Building fire,500,0,500,0,-500
35070,2016,Winter,11/29/2016,1300 ALGONQUIN n/a City of Louisville KY 40208,FALSE,461,461 - Building or structure weakened or collapsed,0,1000,1000,200000,199000
35083,2016,Winter,11/29/2016,3603 MANSLICK n/a City of Louisville KY 40215,FALSE,351,351 - Extrication of victim(s) from building/structure,1000,1000,2000,1000,-1000
35070,2016,Winter,11/29/2016,1300 ALGONQUIN n/a City of Louisville KY 40208,FALSE,461,461 - Building or structure weakened or collapsed,0,1000,1000,200000,199000
35083,2016,Winter,11/29/2016,3603 MANSLICK n/a City of Louisville KY 40215,FALSE,351,351 - Extrication of victim(s) from building/structure,1000,1000,2000,1000,-1000
35274,2016,Winter,12/1/2016,1525 ARCADE N/A City of Louisville KY 40215,Structure Fire,111,111 - Building fire,1,1000,1001,2000,999
35274,2016,Winter,12/1/2016,1525 ARCADE N/A City of Louisville KY 40215,Structure Fire,111,111 - Building fire,0,1000,1000,150000,149000
35274,2016,Winter,12/1/2016,1525 ARCADE N/A City of Louisville KY 40215,Structure Fire,111,111 - Building fire,1,1000,1001,2000,999
35274,2016,Winter,12/1/2016,1525 ARCADE N/A City of Louisville KY 40215,Structure Fire,111,111 - Building fire,0,1000,1000,150000,149000
35409,2016,Winter,12/2/2016,2013 FORT NONE City of Louisville KY 40217,Structure Fire,111,111 - Building fire,500,500,1000,500,-500
35414,2016,Winter,12/2/2016,432 E JEFFERSON 410 City of Louisville KY 40202,Structure Fire,111,111 - Building fire,100,200,300,600000,599700
35409,2016,Winter,12/2/2016,2013 FORT NONE City of Louisville KY 40217,Structure Fire,111,111 - Building fire,500,500,1000,500,-500
35414,2016,Winter,12/2/2016,432 E JEFFERSON 410 City of Louisville KY 40202,Structure Fire,111,111 - Building fire,100,200,300,600000,599700
35554,2016,Winter,12/3/2016,209 YORK apt City of Louisville KY 40203,Structure Fire,111,111 - Building fire,2000,3000,5000,3000,-2000
35554,2016,Winter,12/3/2016,209 YORK apt City of Louisville KY 40203,Structure Fire,111,111 - Building fire,2000,3000,5000,3000,-2000
35594,2016,Winter,12/3/2016,3711 W BROADWAY 2B City of Louisville KY 40211,Structure Fire,111,111 - Building fire,0,3000,3000,120000,117000
35594,2016,Winter,12/3/2016,3711 W BROADWAY 2B City of Louisville KY 40211,Structure Fire,111,111 - Building fire,0,3000,3000,120000,117000
35616,2016,Winter,12/4/2016,SOUTHERN City of Louisville KY 40214,Vehicle Fire,131,131 - Passenger vehicle fire,0,5000,5000,5000,0
35686,2016,Winter,12/4/2016,3007 DON DEE NA City of Cambridge KY 40220,Structure Fire,111,111 - Building fire,10000,25000,35000,145000,110000
35616,2016,Winter,12/4/2016,SOUTHERN City of Louisville KY 40214,Vehicle Fire,131,131 - Passenger vehicle fire,0,5000,5000,5000,0
35686,2016,Winter,12/4/2016,3007 DON DEE NA City of Cambridge KY 40220,Structure Fire,111,111 - Building fire,10000,25000,35000,145000,110000
35944,2016,Winter,12/6/2016,4706 PRESTON NA City of Audubon Park KY 40213,Vehicle Fire,131,131 - Passenger vehicle fire,0,1000,1000,1000,0
35944,2016,Winter,12/6/2016,4706 PRESTON NA City of Audubon Park KY 40213,Vehicle Fire,131,131 - Passenger vehicle fire,0,1000,1000,1000,0
35977,2016,Winter,12/7/2016,5444 NEW CUT n/a City of Louisville KY 40214,Vehicle Fire,131,131 - Passenger vehicle fire,0,50000,50000,50000,0
35977,2016,Winter,12/7/2016,5444 NEW CUT n/a City of Louisville KY 40214,Vehicle Fire,131,131 - Passenger vehicle fire,0,50000,50000,50000,0
36071,2016,Winter,12/8/2016,829 SWAN N/A City of Louisville KY 40204,Structure Fire,111,111 - Building fire,4000,15000,19000,30000,11000
36071,2016,Winter,12/8/2016,829 SWAN N/A City of Louisville KY 40204,Structure Fire,111,111 - Building fire,4000,15000,19000,30000,11000
36285,2016,Winter,12/10/2016,4020 SOUTHERN N/A City of Louisville KY 40214,Structure Fire,111,111 - Building fire,0,60000,60000,112000,52000
36299,2016,Winter,12/10/2016,445 S JACKSON 303 City of Louisville KY 40202,Structure Fire,111,111 - Building fire,0,300,300,300,0
36302,2016,Winter,12/10/2016,652 S 37TH 12 City of Louisville KY 40211,FALSE,461,461 - Building or structure weakened or collapsed,0,3000,3000,250000,247000
36330,2016,Winter,12/10/2016,1210 FISK N/A City of Louisville KY 40203,Structure Fire,113,"113 - Cooking fire, confined to container",2000,0,2000,50000,48000
36299,2016,Winter,12/10/2016,445 S JACKSON 303 City of Louisville KY 40202,Structure Fire,111,111 - Building fire,0,300,300,300,0
36302,2016,Winter,12/10/2016,652 S 37TH 12 City of Louisville KY 40211,FALSE,461,461 - Building or structure weakened or collapsed,0,3000,3000,250000,247000
36330,2016,Winter,12/10/2016,1210 FISK N/A City of Louisville KY 40203,Structure Fire,113,"113 - Cooking fire, confined to container",2000,0,2000,50000,48000
36285,2016,Winter,12/10/2016,4020 SOUTHERN N/A City of Louisville KY 40214,Structure Fire,111,111 - Building fire,0,60000,60000,112000,52000
36422,2016,Winter,12/11/2016,1123 WILLOW None City of Louisville KY 40204,Vehicle Fire,131,131 - Passenger vehicle fire,0,600,600,600,0
36470,2016,Winter,12/11/2016,2329 DUNCAN N/A City of Louisville KY 40212,Structure Fire,111,111 - Building fire,1000,5000,6000,5000,-1000
36422,2016,Winter,12/11/2016,1123 WILLOW None City of Louisville KY 40204,Vehicle Fire,131,131 - Passenger vehicle fire,0,600,600,600,0
36470,2016,Winter,12/11/2016,2329 DUNCAN N/A City of Louisville KY 40212,Structure Fire,111,111 - Building fire,1000,5000,6000,5000,-1000
36496,2016,Winter,12/12/2016,1414 OAKWOOD n/a City of Louisville KY 40215,Structure Fire,111,111 - Building fire,1500,5000,6500,50000,43500
36545,2016,Winter,12/12/2016,1800 W JEFFERSON NA City of Louisville KY 40203,FALSE,461,461 - Building or structure weakened or collapsed,0,2000,2000,238630,236630
36556,2016,Winter,12/12/2016,100 ROCK CLIFF shed City of Louisville KY 40218,Outside Fire,163,163 - Outside gas or vapor combustion explosion,0,500,500,750,250
36496,2016,Winter,12/12/2016,1414 OAKWOOD n/a City of Louisville KY 40215,Structure Fire,111,111 - Building fire,1500,5000,6500,50000,43500
36545,2016,Winter,12/12/2016,1800 W JEFFERSON NA City of Louisville KY 40203,FALSE,461,461 - Building or structure weakened or collapsed,0,2000,2000,238630,236630
36556,2016,Winter,12/12/2016,100 ROCK CLIFF shed City of Louisville KY 40218,Outside Fire,163,163 - Outside gas or vapor combustion explosion,0,500,500,750,250
36592,2016,Winter,12/12/2016,GARDINER City of Kingsley KY 40205,Vehicle Fire,131,131 - Passenger vehicle fire,0,3000,3000,3000,0
36592,2016,Winter,12/12/2016,GARDINER City of Kingsley KY 40205,Vehicle Fire,131,131 - Passenger vehicle fire,0,3000,3000,3000,0
36602,2016,Winter,12/13/2016,425 M n/a City of Louisville KY 40208,Structure Fire,112,112 - Fires in structure other than in a building,200,3000,3200,3000,-200
36602,2016,Winter,12/13/2016,425 M n/a City of Louisville KY 40208,Structure Fire,112,112 - Fires in structure other than in a building,0,500,500,150000,149500
36652,2016,Winter,12/13/2016,I 264 West n/a City of Louisville KY 40211,Vehicle Fire,131,131 - Passenger vehicle fire,0,8500,8500,8500,0
36602,2016,Winter,12/13/2016,425 M n/a City of Louisville KY 40208,Structure Fire,111,111 - Building fire,200,3000,3200,3000,-200
36602,2016,Winter,12/13/2016,425 M n/a City of Louisville KY 40208,Structure Fire,111,111 - Building fire,0,500,500,150000,149500
36652,2016,Winter,12/13/2016,I 264 West n/a City of Louisville KY 40211,Vehicle Fire,131,131 - Passenger vehicle fire,0,8500,8500,8500,0
36779,2016,Winter,12/14/2016,4811 S 3RD B City of Louisville KY 40214,Vehicle Fire,131,131 - Passenger vehicle fire,0,4000,4000,12000,8000
36800,2016,Winter,12/14/2016,2903 W MARKET N/A City of Louisville KY 40212,Structure Fire,111,111 - Building fire,0,30000,30000,32070,2070
36825,2016,Winter,12/15/2016,3309 COLONIAL MANOR 1A City of Louisville KY 40218,Structure Fire,111,111 - Building fire,10000,80000,90000,700000,610000
36828,2016,Winter,12/15/2016,2719 W MARKET none City of Louisville KY 40212,Structure Fire,111,111 - Building fire,2000,20000,22000,49230,27230
36952,2016,Winter,12/16/2016,938 CAMDEN n/a City of Louisville KY 40215,Structure Fire,111,111 - Building fire,5000,10000,15000,55040,40040
36952,2016,Winter,12/16/2016,938 CAMDEN n/a City of Louisville KY 40215,Structure Fire,111,111 - Building fire,5000,10000,15000,55040,40040
36974,2016,Winter,12/16/2016,I 65 South na City of Audubon Park KY 40213,Vehicle Fire,132,132 - Road freight or transport vehicle fire,0,10000,10000,50000,40000
37140,2016,Winter,12/17/2016,TEXAS City of Louisville KY 40217,FALSE,324,324 - Motor vehicle accident with no injuries.,0,3000,3000,3000,0
37213,2016,Winter,12/18/2016,438 E LEE N/A City of Louisville KY 40217,Structure Fire,111,111 - Building fire,2500,25000,27500,94700,67200
37228,2016,Winter,12/18/2016,E BURNETT City of Louisville KY 40217,Vehicle Fire,131,131 - Passenger vehicle fire,100,1500,1600,1500,-100
37292,2016,Winter,12/18/2016,S 40TH City of Louisville KY 40212,Structure Fire,111,111 - Building fire,0,29130,29130,29130,0
16-0037213,2016,Winter,12/18/2016,438 E LEE Louisville KY 40217,Structure Fire,111,111 - Building fire,2500,25000,27500,125000,97500
16-0037228,2016,Winter,12/18/2016,E BURNETT Louisville KY 40217,Vehicle Fire,131,131 - Passenger vehicle fire,100,1500,1600,1500,-100
37213,2016,Winter,12/18/2016,438 E LEE N/A City of Louisville KY 40217,Structure Fire,111,111 - Building fire,2500,25000,27500,94700,67200
37228,2016,Winter,12/18/2016,E BURNETT City of Louisville KY 40217,Vehicle Fire,131,131 - Passenger vehicle fire,100,1500,1600,1500,-100
37292,2016,Winter,12/18/2016,S 40TH City of Louisville KY 40212,Structure Fire,111,111 - Building fire,0,29130,29130,29130,0
16-0037321,2016,Winter,12/19/2016,9910 BUCKINGHAM City of South Park View KY 40219,Vehicle Fire,131,131 - Passenger vehicle fire,500,10000,10500,10000,-500
16-0037458,2016,Winter,12/20/2016,I 264 Louisville KY 40209,Vehicle Fire,131,131 - Passenger vehicle fire,NULL,8000,8000,8000,0
16-0037465,2016,Winter,12/20/2016,I 264 West Louisville KY 40213,Vehicle Fire,131,131 - Passenger vehicle fire,NULL,2000,2000,2000,0
16-0037454,2016,Winter,12/20/2016,446 MOUNT HOLLY Louisville KY 40206,FALSE,735,735 - Alarm system sounded due to malfunction,400,1000,1400,3990000,3988600
37418,2016,Winter,12/20/2016,915 EASTERN none City of Louisville KY 40217,FALSE,324,324 - Motor vehicle accident with no injuries.,0,500,500,500,0
37454,2016,Winter,12/20/2016,446 MOUNT HOLLY n/a City of Louisville KY 40206,FALSE,522,522 - Water or steam leak,400,1000,1400,3990000,3988600
37458,2016,Winter,12/20/2016,I 264 East n/a City of Louisville KY 40209,Vehicle Fire,131,131 - Passenger vehicle fire,0,8000,8000,8000,0
37465,2016,Winter,12/20/2016,I 264 West na City of Audubon Park KY 40213,Vehicle Fire,131,131 - Passenger vehicle fire,0,2000,2000,2000,0
37418,2016,Winter,12/20/2016,915 EASTERN none City of Louisville KY 40217,FALSE,324,324 - Motor vehicle accident with no injuries.,0,500,500,500,0
37454,2016,Winter,12/20/2016,446 MOUNT HOLLY n/a City of Louisville KY 40206,FALSE,522,522 - Water or steam leak,400,1000,1400,3990000,3988600
37458,2016,Winter,12/20/2016,I 264 East n/a City of Louisville KY 40209,Vehicle Fire,131,131 - Passenger vehicle fire,0,8000,8000,8000,0
37465,2016,Winter,12/20/2016,I 264 West na City of Audubon Park KY 40213,Vehicle Fire,131,131 - Passenger vehicle fire,0,2000,2000,2000,0
16-0037605,2016,Winter,12/21/2016,1801 S 23RD Louisville KY 40210,Structure Fire,111,111 - Building fire,500,1000,1500,90000,88500
16-0037720,2016,Winter,12/22/2016,2211 GERALD Louisville KY 40218,Structure Fire,118,"118 - Trash or rubbish fire, contained",NULL,600,600,280800,280200
16-0037739,2016,Winter,12/22/2016,1539 LONGFIELD Louisville KY 40215,Outside Fire,161,161 - Outside storage fire,2000,2000,4000,2000,-2000
37720,2016,Winter,12/22/2016,2211 GERALD N/A City of Louisville KY 40218,Structure Fire,118,"118 - Trash or rubbish fire, contained",0,600,600,280800,280200
37739,2016,Winter,12/22/2016,1539 LONGFIELD outside/storage City of Louisville KY 40215,Outside Fire,161,161 - Outside storage fire,3000,1500,4500,1500,-3000
37775,2016,Winter,12/23/2016,1519 CRUMS 28 City of Louisville KY 40216,Structure Fire,111,111 - Building fire,20000,50000,70000,60000,-10000
16-0037775,2016,Winter,12/23/2016,1519 CRUMS 28 Louisville KY 40216,Structure Fire,111,111 - Building fire,10000,25000,35000,40000,5000
16-0037815,2016,Winter,12/23/2016,4106 W MUHAMMAD ALI Louisville KY 40212,Vehicle Fire,131,131 - Passenger vehicle fire,NULL,3000,3000,4000,1000
37775,2016,Winter,12/23/2016,1519 CRUMS 28 City of Louisville KY 40216,Structure Fire,111,111 - Building fire,20000,50000,70000,60000,-10000
37815,2016,Winter,12/23/2016,4106 W MUHAMMAD ALI N/A City of Louisville KY 40212,Vehicle Fire,131,131 - Passenger vehicle fire,0,3000,3000,4000,1000
37815,2016,Winter,12/23/2016,4106 W MUHAMMAD ALI N/A City of Louisville KY 40212,Vehicle Fire,131,131 - Passenger vehicle fire,0,3000,3000,4000,1000
37944,2016,Winter,12/25/2016,1628 NORTHWESTERN N/A City of Louisville KY 40203,Structure Fire,111,111 - Building fire,10000,45000,55000,229780,174780
37944,2016,Winter,12/25/2016,1630 NORTHWESTERN N/A City of Louisville KY 40203,Structure Fire,111,111 - Building fire,10000,25000,35000,229780,194780
37944,2016,Winter,12/25/2016,1632 NORTHWESTERN N/A City of Louisville KY 40203,Structure Fire,111,111 - Building fire,10000,25000,35000,229780,194780
37951,2016,Winter,12/25/2016,1270 WELLER N/A City of Louisville KY 40208,Structure Fire,111,111 - Building fire,2000,10000,12000,15000,3000
37992,2016,Winter,12/25/2016,2306 W MUHAMMAD ALI N/A City of Louisville KY 40212,Structure Fire,111,111 - Building fire,50,100,150,40000,39850
16-0037944,2016,Winter,12/25/2016,1628 NORTHWESTERN Louisville KY 40203,Structure Fire,111,111 - Building fire,10000,4500,14500,229780,215280
16-0037951,2016,Winter,12/25/2016,1270 WELLER Louisville KY 40208,Structure Fire,111,111 - Building fire,2000,10000,12000,15000,3000
16-0038001,2016,Winter,12/25/2016,2824 W MARKET Louisville KY 40212,FALSE,150,"150 - Outside rubbish fire, other",400,NULL,400,400,0
38001,2016,Winter,12/25/2016,2824 W MARKET N/A City of Louisville KY 40212,Outside Fire,150,"150 - Outside rubbish fire, other",400,0,400,0,-400
37944,2016,Winter,12/25/2016,1632 NORTHWESTERN N/A City of Louisville KY 40203,Structure Fire,111,111 - Building fire,10000,25000,35000,229780,194780
37944,2016,Winter,12/25/2016,1630 NORTHWESTERN N/A City of Louisville KY 40203,Structure Fire,111,111 - Building fire,10000,25000,35000,229780,194780
38001,2016,Winter,12/25/2016,2824 W MARKET N/A City of Louisville KY 40212,Outside Fire,150,"150 - Outside rubbish fire, other",400,0,400,0,-400
38054,2016,Winter,12/26/2016,2801 TAYLORSVILLE Bldg D City of Kingsley KY 40205,Vehicle Fire,135,135 - Aircraft fire,0,10000,10000,500000,490000
16-0038054,2016,Winter,12/26/2016,2801 TAYLORSVILLE Louisville KY 40205,Vehicle Fire,135,135 - Aircraft fire,NULL,10000,10000,500000,490000
38054,2016,Winter,12/26/2016,2801 TAYLORSVILLE Bldg D City of Kingsley KY 40205,Vehicle Fire,135,135 - Aircraft fire,0,10000,10000,500000,490000
38145,2016,Winter,12/27/2016,3311 UTAH N/A City of Louisville KY 40215,Structure Fire,111,111 - Building fire,0,10000,10000,20000,10000
38191,2016,Winter,12/27/2016,722 S 42ND NA City of Louisville KY 40211,Structure Fire,113,"113 - Cooking fire, confined to container",40,0,40,NULL,NULL
38194,2016,Winter,12/27/2016,1609 LUCIA 0 City of Louisville KY 40204,Structure Fire,111,111 - Building fire,0,1000,1000,250000,249000
38200,2016,Winter,12/27/2016,200 STEEDLY n/a City of Louisville KY 40214,Vehicle Fire,131,131 - Passenger vehicle fire,0,100,100,100,0
38225,2016,Winter,12/27/2016,3038 HALE NA City of Louisville KY 40211,Structure Fire,113,"113 - Cooking fire, confined to container",250,0,250,0,-250
16-0038142,2016,Winter,12/27/2016,1417 OLEANDA Louisville KY 40215,Structure Fire,111,111 - Building fire,NULL,20000,20000,20000,0
16-0038145,2016,Winter,12/27/2016,3311 UTAH Louisville KY 40215,Structure Fire,111,111 - Building fire,NULL,10000,10000,20000,10000
16-0038194,2016,Winter,12/27/2016,1609 LUCIA Louisville KY 40204,Structure Fire,111,111 - Building fire,NULL,1000,1000,250000,249000
38191,2016,Winter,12/27/2016,722 S 42ND NA City of Louisville KY 40211,Structure Fire,113,"113 - Cooking fire, confined to container",40,0,40,NULL,NULL
38194,2016,Winter,12/27/2016,1609 LUCIA 0 City of Louisville KY 40204,Structure Fire,111,111 - Building fire,0,1000,1000,250000,249000
38200,2016,Winter,12/27/2016,200 STEEDLY n/a City of Louisville KY 40214,Vehicle Fire,131,131 - Passenger vehicle fire,0,100,100,100,0
38205,2016,Winter,12/27/2016,7320 SOUTHSIDE 93 City of Louisville KY 40214,Structure Fire,111,111 - Building fire,2500,25000,27500,25000,-2500
38225,2016,Winter,12/27/2016,3038 HALE NA City of Louisville KY 40211,Structure Fire,113,"113 - Cooking fire, confined to container",250,0,250,0,-250
38243,2016,Winter,12/27/2016,4149 GARLAND NA City of Louisville KY 40211,Vehicle Fire,130,"130 - Mobile property (vehicle) fire, other",250,9000,9250,9000,-250
38142,2016,Winter,12/27/2016,1417 OLEANDA N/A City of Louisville KY 40215,Structure Fire,111,111 - Building fire,0,20000,20000,20000,0
38145,2016,Winter,12/27/2016,3311 UTAH N/A City of Louisville KY 40215,Structure Fire,111,111 - Building fire,0,10000,10000,20000,10000
16-0038243,2016,Winter,12/27/2016,4149 GARLAND Louisville KY 40211,Vehicle Fire,130,"130 - Mobile property (vehicle) fire, other",250,9000,9250,9000,-250
38243,2016,Winter,12/27/2016,4149 GARLAND NA City of Louisville KY 40211,Vehicle Fire,131,131 - Passenger vehicle fire,250,9000,9250,9000,-250
38263,2016,Winter,12/28/2016,3010 WYANDOTTE NA City of Louisville KY 40210,FALSE,445,"445 - Arcing, shorted electrical equipment",0,1000,1000,23410,22410
16-0038252,2016,Winter,12/28/2016,440 BAXTER Louisville KY 40204,FALSE,324,324 - Motor vehicle accident with no injuries.,1000,5000,6000,500000,494000
16-0038263,2016,Winter,12/28/2016,3010 WYANDOTTE Louisville KY 40210,FALSE,441,"441 - Heat from short circuit (wiring), defective/worn",0,1500,1500,90000,88500
16-0038338,2016,Winter,12/28/2016,815 S SHELBY Louisville KY 40203,Structure Fire,111,111 - Building fire,25000,50000,75000,75000,0
38263,2016,Winter,12/28/2016,3010 WYANDOTTE NA City of Louisville KY 40210,FALSE,445,"445 - Arcing, shorted electrical equipment",0,1000,1000,23410,22410
38338,2016,Winter,12/28/2016,815 S SHELBY n/a City of Louisville KY 40203,Structure Fire,111,111 - Building fire,25000,50000,75000,75000,0
38448,2016,Winter,12/29/2016,3016 MONTANA n/a City of Louisville KY 40208,Vehicle Fire,131,131 - Passenger vehicle fire,0,2500,2500,2500,0
16-0038397,2016,Winter,12/29/2016,I-264 E at I-65 City of Louisville KY 40213,Vehicle Fire,131,131 - Passenger vehicle fire,500,2000,2500,20000,17500
38397,2016,Winter,12/29/2016,I 264 East n/a City of Audubon Park KY 40213,Vehicle Fire,131,131 - Passenger vehicle fire,500,2000,2500,2000,-500
16-0038448,2016,Winter,12/29/2016,3116 MONTANA Louisville KY 40208,Vehicle Fire,131,131 - Passenger vehicle fire,NULL,2500,2500,2500,0
38397,2016,Winter,12/29/2016,I 264 East n/a City of Audubon Park KY 40213,Vehicle Fire,131,131 - Passenger vehicle fire,500,2000,2500,2000,-500
38448,2016,Winter,12/29/2016,3016 MONTANA n/a City of Louisville KY 40208,Vehicle Fire,131,131 - Passenger vehicle fire,0,2500,2500,2500,0
38467,2016,Winter,12/30/2016,1518 W MARKET 2 City of Louisville KY 40203,Structure Fire,111,111 - Building fire,0,1500,1500,1500,0
38482,2016,Winter,12/30/2016,3228 W MARKET NA City of Louisville KY 40212,Structure Fire,113,"113 - Cooking fire, confined to container",0,100,100,27170,27070
38485,2016,Winter,12/30/2016,5507 SOUTHERN basement City of Louisville KY 40214,Structure Fire,111,111 - Building fire,500,500,1000,180000,179000
16-0038467,2016,Winter,12/30/2016,1514 W MARKET 2 Louisville KY 40203,Structure Fire,111,111 - Building fire,NULL,1500,1500,1500,0
16-0038482,2016,Winter,12/30/2016,3228 W MARKET Louisville KY 40212,Structure Fire,113,"113 - Cooking fire, confined to container",NULL,100,100,27170,27070
16-0038485,2016,Winter,12/30/2016,5507 SOUTHERN Louisville KY 40214,Structure Fire,111,111 - Building fire,500,500,1000,180000,179000
38482,2016,Winter,12/30/2016,3228 W MARKET NA City of Louisville KY 40212,Structure Fire,113,"113 - Cooking fire, confined to container",0,100,100,27170,27070
38565,2016,Winter,12/31/2016,1009 BROOKLINE 2 City of Louisville KY 40215,Structure Fire,111,111 - Building fire,0,1000,1000,190000,189000
38598,2016,Winter,12/31/2016,1604 GALLAGHER na City of Louisville KY 40210,Structure Fire,111,111 - Building fire,10000,20000,30000,20000,-10000
38598,2016,Winter,12/31/2016,1610 GALLAGHER na City of Louisville KY 40210,Structure Fire,111,111 - Building fire,0,200,200,17000,16800
38598,2016,Winter,12/31/2016,1610 GALLAGHER na City of Louisville KY 40210,Structure Fire,111,111 - Building fire,500,10000,10500,10000,-500
38638,2016,Winter,12/31/2016,4224 LEE N/A City of Audubon Park KY 40213,Structure Fire,111,111 - Building fire,10000,30000,40000,160000,120000
38598,2016,Winter,12/31/2016,1610 GALLAGHER na City of Louisville KY 40210,Structure Fire,111,111 - Building fire,500,10000,10500,10000,-500
38598,2016,Winter,12/31/2016,1610 GALLAGHER na City of Louisville KY 40210,Structure Fire,111,111 - Building fire,0,200,200,17000,16800
38598,2016,Winter,12/31/2016,1604 GALLAGHER na City of Louisville KY 40210,Structure Fire,111,111 - Building fire,10000,20000,30000,20000,-10000
38626,2016,Winter,12/31/2016,S 7TH City of Louisville KY 40202,Structure Fire,111,111 - Building fire,100000,250000,350000,3000000,2650000
38638,2016,Winter,12/31/2016,4224 LEE N/A City of Audubon Park KY 40213,Structure Fire,111,111 - Building fire,10000,30000,40000,160000,120000
16-0038539,2016,Winter,12/31/2016,3502 7TH STREET SHV KY 40216,Structure Fire,111,111 - Building fire,NULL,285000,285000,285000,0
16-0038565,2016,Winter,12/31/2016,1009 BROOKLINE 2 Louisville KY 40215,Structure Fire,111,111 - Building fire,1000,100,1100,146000,144900
16-0038598,2016,Winter,12/31/2016,1610 GALLAGHER Louisville KY 40210,Structure Fire,111,111 - Building fire,10000,25000,35000,25000,-10000
38565,2016,Winter,12/31/2016,1009 BROOKLINE 2 City of Louisville KY 40215,Structure Fire,113,"113 - Cooking fire, confined to container",0,1000,1000,190000,189000
16-0038626,2016,Winter,12/31/2016,222 S 7th Louisville KY 40202,Structure Fire,111,111 - Building fire,100000,250000,350000,3000000,2650000
16-0038638,2016,Winter,12/31/2016,4224 LEE Louisville KY 40213,Structure Fire,111,111 - Building fire,10000,30000,40000,160000,120000
17-0000034,2017,Winter,1/1/2017,1551 W ORMSBY Louisville KY 40210,Structure Fire,100,"100 - Fire, other",100,0,100,67320,67220
17-0000088,2017,Winter,1/1/2017,1442 W SOUTHERN HEIGHTS Louisville KY 40215,FALSE,441,"441 - Heat from short circuit (wiring), defective/worn",100,NULL,100,65000,64900
17-0000192,2017,Winter,1/2/2017,3320 Bank Louisville KY 40212,Vehicle Fire,131,131 - Passenger vehicle fire,NULL,4500,4500,5000,500
17-0000222,2017,Winter,1/2/2017,3012 S 5th Louisville KY 40208,Structure Fire,111,111 - Building fire,0,61000,61000,61000,0
17-0000222,2017,Winter,1/2/2017,3012 S 5th Louisville KY 40208,Structure Fire,111,111 - Building fire,8000,56040,64040,56040,-8000
17-0000427,2017,Winter,1/4/2017,749 CAMP EDWARDS Louisville KY 40203,Structure Fire,111,111 - Building fire,300,1000,1300,59050,57750
17-0000455,2017,Winter,1/4/2017,3620 MANSLICK Louisville KY 40215,Structure Fire,111,111 - Building fire,5000,20000,25000,390000,365000
17-0000457,2017,Winter,1/5/2017,3616 MANSLICK Louisville KY 40215,Structure Fire,111,111 - Building fire,0,5000,5000,390000,385000
17-0000473,2017,Winter,1/5/2017,2711 VIRGINIA Louisville KY 40211,Vehicle Fire,131,131 - Passenger vehicle fire,200,2500,2700,2500,-200
17-0000567,2017,Winter,1/6/2017,2726 ALFORD Louisville KY 40212,Vehicle Fire,131,131 - Passenger vehicle fire,NULL,3600,3600,3600,0
17-0000591,2017,Winter,1/6/2017,125 STEVENSON Louisville KY 40206,FALSE,445,"445 - Arcing, shorted electrical equipment",200,NULL,200,50000,49800
17-0000641,2017,Winter,1/7/2017,2910 CLEVELAND Louisville KY 40206,Structure Fire,111,111 - Building fire,25000,80000,105000,123000,18000
17-0000726,2017,Winter,1/7/2017,3207 MILDRED SHV KY 40216,Structure Fire,111,111 - Building fire,1000,5000,6000,65000,59000
17-0000735,2017,Winter,1/8/2017,1292 CHEROKEE Louisville KY 40204,Structure Fire,111,111 - Building fire,0,200,200,500000,499800
17-0000870,2017,Winter,1/9/2017,5503 S 3RD Louisville KY 40214,Structure Fire,111,111 - Building fire,5000,10000,15000,80000,65000
17-0000900,2017,Winter,1/9/2017,537 N 20TH Louisville KY 40203,Structure Fire,111,111 - Building fire,500,5000,5500,31440,25940
17-0000899,2017,Winter,1/9/2017,S 25TH Louisville KY 40211,Vehicle Fire,131,131 - Passenger vehicle fire,NULL,2000,2000,2000,0
17-0001076,2017,Winter,1/10/2017,S 40TH Louisville KY 40212,Structure Fire,113,"113 - Cooking fire, confined to container",500,2000,2500,80000,77500
17-0001081,2017,Winter,1/10/2017,2731 GREENWOOD Louisville KY 40211,Structure Fire,111,111 - Building fire,100,5000,5100,22070,16970
17-0001157,2017,Winter,1/11/2017,724 DENMARK Louisville KY 40215,Vehicle Fire,131,131 - Passenger vehicle fire,0,200,200,500,300
17-0001183,2017,Winter,1/11/2017,945 S 5TH 219 Louisville KY 40203,Structure Fire,113,"113 - Cooking fire, confined to container",NULL,1000,1000,1500000,1499000
17-0001208,2017,Winter,1/11/2017,1929 S 28TH Louisville KY 40210,Structure Fire,113,"113 - Cooking fire, confined to container",400,NULL,400,55000,54600
17-0001211,2017,Winter,1/11/2017,1770 WILSON Louisville KY 40210,Structure Fire,111,111 - Building fire,1000,3000,4000,30000,26000
17-0001228,2017,Winter,1/12/2017,1214 CEDAR Louisville KY 40203,Structure Fire,113,"113 - Cooking fire, confined to container",500,500,1000,5550,4550
17-0001357,2017,Winter,1/13/2017,3809 WEWOKA Louisville KY 40212,Structure Fire,118,"118 - Trash or rubbish fire, contained",500,NULL,500,50000,49500
17-0001442,2017,Winter,1/14/2017,1374 S 2ND Louisville KY 40208,Structure Fire,111,111 - Building fire,10000,50000,60000,250000,190000
17-0001443,2017,Winter,1/14/2017,1206 PLACE D'OR Louisville KY 40203,Vehicle Fire,131,131 - Passenger vehicle fire,NULL,2000,2000,2000,0
17-0001500,2017,Winter,1/14/2017,4301 W MARKET Louisville KY 40212,Structure Fire,111,111 - Building fire,10000,30000,40000,132310,92310
17-0001669,2017,Winter,1/16/2017,804 RIVER CREST 804 Louisville KY 40206,Structure Fire,113,"113 - Cooking fire, confined to container",1500,2500,4000,100000,96000
17-0001672,2017,Winter,1/16/2017,222 S 24TH Louisville KY 40212,Structure Fire,111,111 - Building fire,NULL,2000,2000,2000,0
17-0001788,2017,Winter,1/17/2017,124 E OAK 2 Louisville KY 40203,Structure Fire,111,111 - Building fire,1000,1000,2000,100000,98000
17-0001800,2017,Winter,1/18/2017,625 S SHELBY Louisville KY 40202,Vehicle Fire,130,"130 - Mobile property (vehicle) fire, other",100,3000,3100,3000,-100
17-0001807,2017,Winter,1/18/2017,3620 WOODRUFF Louisville KY 40215,Structure Fire,111,111 - Building fire,NULL,3000,3000,60000,57000
17-0001880,2017,Winter,1/18/2017,1105 S SHELBY Louisville KY 40203,Structure Fire,111,111 - Building fire,10000,36000,46000,55570,9570
17-0001880,2017,Winter,1/18/2017,1103 S. Shelby City of Louisville KY 40204,Structure Fire,111,111 - Building fire,NULL,5000,5000,56350,51350
17-0001902,2017,Winter,1/19/2017,665 HECKS Louisville KY 40211,Vehicle Fire,131,131 - Passenger vehicle fire,NULL,1500,1500,1500,0
17-0001928,2017,Winter,1/19/2017,Watterson Louisville KY 40216,Vehicle Fire,130,"130 - Mobile property (vehicle) fire, other",500,6000,6500,6000,-500
17-0001994,2017,Winter,1/20/2017,841 S 23RD Louisville KY 40211,FALSE,151,"151 - Outside rubbish, trash or waste fire",20,NULL,20,18540,18520
17-0002278,2017,Winter,1/23/2017,410 N 34TH Louisville KY 40212,Structure Fire,111,111 - Building fire,0,5000,5000,43000,38000
17-0002395,2017,Winter,1/24/2017,324 N 19TH Louisville KY 40203,Structure Fire,111,111 - Building fire,6000,10000,16000,19550,3550
17-0002457,2017,Winter,1/24/2017,3668 WOODRUFF Louisville KY 40215,Structure Fire,111,111 - Building fire,200,500,700,75000,74300
17-0002598,2017,Winter,1/26/2017,2504 STANDARD Louisville KY 40210,Structure Fire,111,111 - Building fire,2000,5000,7000,25390,18390
17-0002605,2017,Winter,1/26/2017,2936 BANK Louisville KY 40212,Structure Fire,111,111 - Building fire,15000,30910,45910,30910,-15000
17-0002723,2017,Winter,1/27/2017,845 CLARKS Louisville KY 40217,Vehicle Fire,130,"130 - Mobile property (vehicle) fire, other",NULL,500,500,10000,9500
17-0002727,2017,Winter,1/27/2017,2606 KINGS KING KY 40205,Structure Fire,100,"100 - Fire, other",NULL,250,250,300000,299750
17-0002947,2017,Winter,1/29/2017,1716 W ORMSBY Louisville KY 40210,Structure Fire,111,111 - Building fire,NULL,500,500,60000,59500
17-0002971,2017,Winter,1/30/2017,2527 W JEFFERSON Louisville KY 40212,Structure Fire,111,111 - Building fire,1000,9000,10000,15000,5000
17-0003116,2017,Winter,1/31/2017,1700 W CHESTNUT Louisville KY 40203,Structure Fire,111,111 - Building fire,1000,2000,3000,5000,2000
17-0003187,2017,Spring,2/1/2017,816 IROQUOIS Louisville KY 40214,Structure Fire,111,111 - Building fire,500,2500,3000,127000,124000
17-0003227,2017,Spring,2/1/2017,1615 S 32ND Louisville KY 40211,Structure Fire,111,111 - Building fire,5000,5000,10000,109780,99780
17-0003269,2017,Spring,2/2/2017,201 MERIDIAN Louisville KY 40207,Structure Fire,111,111 - Building fire,300000,460000,760000,460001,-299999
17-0003309,2017,Spring,2/2/2017,1488 S SHELBY Louisville KY 40217,Structure Fire,111,111 - Building fire,NULL,40000,40000,40000,0
17-0003381,2017,Spring,2/3/2017,888 W MARKET Louisville KY 40202,Structure Fire,111,111 - Building fire,200,NULL,200,10000000,9999800
17-0003434,2017,Spring,2/3/2017,2232 BARDSTOWN Louisville KY 40205,Outside Fire,154,154 - Dumpster or other outside trash receptacle fire,0,200,200,739000,738800
17-0003477,2017,Spring,2/3/2017,1314 BARDSTOWN Louisville KY 40204,Vehicle Fire,131,131 - Passenger vehicle fire,NULL,2000,2000,2000,0
17-0003477,2017,Spring,2/3/2017,1314 Bardstown City of Louisville KY 40204,Vehicle Fire,131,131 - Passenger vehicle fire,NULL,1000,1000,5000,4000
17-0003534,2017,Spring,2/4/2017,2211 HEATHER Louisville KY 40218,Structure Fire,111,111 - Building fire,NULL,200,200,150000,149800
17-0003533,2017,Spring,2/4/2017,653 S mix Louisville KY 40208,Structure Fire,118,"118 - Trash or rubbish fire, contained",200,400,600,36000,35400
17-0003544,2017,Spring,2/4/2017,3948 TAYLORSVILLE Louisville KY 40220,Vehicle Fire,131,131 - Passenger vehicle fire,NULL,1000,1000,3000,2000
17-0003681,2017,Spring,2/5/2017,1824 Baird Louisville KY 40203,Structure Fire,111,111 - Building fire,0,10000,10000,25000,15000
17-0003685,2017,Spring,2/5/2017,132 S SHAWNEE Louisville KY 40212,Vehicle Fire,138,138 - Off-road vehicle or heavy equipment fire,NULL,1000,1000,2000,1000
17-0003686,2017,Spring,2/5/2017,1416 LYTLE Louisville KY 40203,Vehicle Fire,132,132 - Road freight or transport vehicle fire,5000,5000,10000,5000,-5000
17-0003686,2017,Spring,2/5/2017,1416 Lytle City of Louisville KY 40203,Structure Fire,111,111 - Building fire,5000,5000,10000,250000,240000
17-0003726,2017,Spring,2/6/2017,1103 Dixie City of Louisville KY 40210,Structure Fire,111,111 - Building fire,NULL,1000,1000,21310,20310
17-0003801,2017,Spring,2/6/2017,4524 RIVERVIEW Louisville KY 40211,Structure Fire,111,111 - Building fire,2500,5000,7500,48640,41140
17-0003726,2017,Spring,2/6/2017,1101 DIXIE Louisville KY 40210,Structure Fire,111,111 - Building fire,NULL,49500,49500,49500,0
17-0003909,2017,Spring,2/7/2017,3764 POWELL Louisville KY 40215,Structure Fire,111,111 - Building fire,0,5000,5000,15000,10000
17-0004049,2017,Spring,2/9/2017,409 E MUHAMMAD ALI Louisville KY 40202,Structure Fire,113,"113 - Cooking fire, confined to container",150,200,350,6110640,6110290
17-0004105,2017,Spring,2/9/2017,604 BLUEGRASS 1 Louisville KY 40214,Structure Fire,111,111 - Building fire,30000,200000,230000,515000,285000
17-0004165,2017,Spring,2/10/2017,1455 S 2ND Louisville KY 40208,Structure Fire,111,111 - Building fire,1000,10000,11000,151000,140000
17-0004258,2017,Spring,2/11/2017,2005 TERRIL Louisville KY 40218,Structure Fire,111,111 - Building fire,10000,25000,35000,390170,355170
17-0004351,2017,Spring,2/11/2017,S 6TH Louisville KY 40202,Vehicle Fire,131,131 - Passenger vehicle fire,0,2000,2000,2000,0
17-0004364,2017,Spring,2/12/2017,2529 W JEFFERSON Louisville KY 40212,FALSE,481,481 - Attempt to burn,NULL,200,200,30010,29810
17-0004382,2017,Spring,2/12/2017,2123 W MUHAMMAD ALI Louisville KY 40212,Structure Fire,111,111 - Building fire,1000,5000,6000,31440,25440
17-0004457,2017,Spring,2/13/2017,1631 BRASHEAR Louisville KY 40210,Vehicle Fire,131,131 - Passenger vehicle fire,NULL,4000,4000,4000,0
17-0004531,2017,Spring,2/13/2017,1515 CLARA Louisville KY 40215,Structure Fire,111,111 - Building fire,1000,12000,13000,90000,77000
17-0004609,2017,Spring,2/14/2017,1367 GARDINER WTPK KY 40213,Structure Fire,111,111 - Building fire,NULL,50,50,8550000,8549950
17-0004687,2017,Spring,2/15/2017,2707 TAYLOR Louisville KY 40208,Structure Fire,111,111 - Building fire,15000,40000,55000,80000,25000
17-0004764,2017,Spring,2/16/2017,3408 BRECKENRIDGE 1 Louisville KY 40220,Structure Fire,111,111 - Building fire,5000,20000,25000,408000,383000
17-0004879,2017,Spring,2/16/2017,2216 GERALD Louisville KY 40218,Outside Fire,161,161 - Outside storage fire,1000,6000,7000,6000,-1000
17-0004879,2017,Spring,2/16/2017,2216 gerald City of Louisville KY 40218,Structure Fire,111,111 - Building fire,1000,3200,4200,6000,1800
17-0004879,2017,Spring,2/16/2017,2216 Gerald City of Louisville KY 40218,Structure Fire,111,111 - Building fire,1000,1000,2000,6000,4000
17-0004947,2017,Spring,2/17/2017,5202 PRESTON Louisville KY 40213,Structure Fire,111,111 - Building fire,NULL,500,500,200000,199500
17-0005008,2017,Spring,2/18/2017,320 ARMSTRONG Louisville KY 40208,FALSE,480,"480 - Attempted burning, illegal action, other",800,0,800,200000,199200
17-0005032,2017,Spring,2/18/2017,840 RIVER CREST Louisville KY 40206,Vehicle Fire,131,131 - Passenger vehicle fire,NULL,1200,1200,1200,0
17-0005075,2017,Spring,2/18/2017,3510 W MAIN Louisville KY 40212,Structure Fire,111,111 - Building fire,NULL,1000,1000,35000,34000
17-0005121,2017,Spring,2/19/2017,4135 W BROADWAY Louisville KY 40211,Structure Fire,111,111 - Building fire,10000,33000,43000,66160,23160
17-0005125,2017,Spring,2/19/2017,I 264 East City of Louisville KY 40220,Vehicle Fire,131,131 - Passenger vehicle fire,0,1500,1500,1500,0
17-0005261,2017,Spring,2/20/2017,67 COLLEGE Louisville KY 40203,Vehicle Fire,130,"130 - Mobile property (vehicle) fire, other",200,2000,2200,2000,-200
17-0005389,2017,Spring,2/21/2017,I-264 East City of Louisville KY 40218,Vehicle Fire,131,131 - Passenger vehicle fire,0,1500,1500,4000,2500
17-0005625,2017,Spring,2/23/2017,1719 THERESA SHV KY 40216,Structure Fire,111,111 - Building fire,20000,10000,30000,20000,-10000
17-0005700,2017,Spring,2/24/2017,1110 RED FOX Louisville KY 40205,FALSE,140,"140 - Natural vegetation fire, other",NULL,100,100,1184540,1184440
17-0005715,2017,Spring,2/24/2017,2700 FRANKFORT Louisville KY 40206,Vehicle Fire,131,131 - Passenger vehicle fire,NULL,1000,1000,12000,11000
17-0005735,2017,Spring,2/24/2017,4800BLK S 5TH Louisville KY 40214,Vehicle Fire,131,131 - Passenger vehicle fire,NULL,4000,4000,4000,0
17-0005975,2017,Spring,2/26/2017,801 S 42nd City of Louisville KY 40211,Structure Fire,111,111 - Building fire,NULL,100,100,1000,900
17-0006017,2017,Spring,2/27/2017,1779 W HILL Louisville KY 40210,Structure Fire,111,111 - Building fire,NULL,5000,5000,16250,11250
17-0006302,2017,Spring,3/1/2017,1224 W ASHLAND Louisville KY 40215,Structure Fire,113,"113 - Cooking fire, confined to container",500,0,500,95000,94500
17-0006422,2017,Spring,3/2/2017,2104 DAVID GRAVES City of Louisville KY 40218,Structure Fire,111,111 - Building fire,500,NULL,500,500,0
17-0006508,2017,Spring,3/3/2017,TAYLOR Louisville KY 40215,Outside Fire,154,154 - Dumpster or other outside trash receptacle fire,0,58,58,58,0
17-0006585,2017,Spring,3/4/2017,2333 W MUHAMMAD ALI Louisville KY 40212,Structure Fire,111,111 - Building fire,15000,20000,35000,28630,-6370
17-0006611,2017,Spring,3/4/2017,Crittenden Dr City of Louisville KY 40209,Vehicle Fire,131,131 - Passenger vehicle fire,0,8000,8000,8000,0
17-0006657,2017,Spring,3/5/2017,436 S HITE 3 Louisville KY 40206,Structure Fire,111,111 - Building fire,30000,100000,130000,400000,270000
17-0006724,2017,Spring,3/5/2017,910 DENMARK Louisville KY 40215,FALSE,151,"151 - Outside rubbish, trash or waste fire",NULL,1000,1000,1000,0
17-0006734,2017,Spring,3/5/2017,612 WILDERNESS Louisville KY 40214,Vehicle Fire,130,"130 - Mobile property (vehicle) fire, other",NULL,1500,1500,1500,0
17-0006830,2017,Spring,3/7/2017,2637 HALE Louisville KY 40211,Structure Fire,111,111 - Building fire,0,500,500,50000,49500
17-0006985,2017,Spring,3/8/2017,3439 NEWBURG 5 Louisville KY 40218,Structure Fire,111,111 - Building fire,2500,50000,52500,200000,147500
17-0007006,2017,Spring,3/8/2017,1318 MORGAN Louisville KY 40213,Structure Fire,111,111 - Building fire,NULL,10000,10000,75000,65000
17-0007054,2017,Spring,3/9/2017,414 DOWNES Louisville KY 40214,Structure Fire,111,111 - Building fire,2000,10000,12000,10000,-2000
17-0007157,2017,Spring,3/10/2017,S 13TH Louisville KY 40203,Vehicle Fire,131,131 - Passenger vehicle fire,NULL,500,500,2500,2000
17-0007200,2017,Spring,3/10/2017,613 M Louisville KY 40208,Structure Fire,111,111 - Building fire,NULL,5000,5000,43610,38610
17-0007200,2017,Spring,3/10/2017,615 M Louisville KY 40208,Structure Fire,111,111 - Building fire,10000,30000,40000,52830,12830
17-0007250,2017,Spring,3/11/2017,1700 LANG Louisville KY 40211,Vehicle Fire,131,131 - Passenger vehicle fire,NULL,10000,10000,15000,5000
17-0007313,2017,Spring,3/12/2017,1816 STANDARD Louisville KY 40210,Structure Fire,111,111 - Building fire,1000,15000,16000,15000,-1000
17-0007314,2017,Spring,3/12/2017,310 E JACOB Louisville KY 40203,Structure Fire,111,111 - Building fire,NULL,105000,105000,105000,0
17-0007495,2017,Spring,3/13/2017,2009 PEABODY 7 Louisville KY 40218,Structure Fire,113,"113 - Cooking fire, confined to container",1000,NULL,1000,500000,499000
17-0007453,2017,Spring,3/13/2017,1913 LYTLE Louisville KY 40203,Structure Fire,111,111 - Building fire,0,14000,14000,28000,14000
17-0007485,2017,Spring,3/13/2017,2716 N BANK Louisville KY 40212,Structure Fire,111,111 - Building fire,1000,31160,32160,33660,1500
17-0007509,2017,Spring,3/14/2017,2235 GRAND Louisville KY 40210,Vehicle Fire,131,131 - Passenger vehicle fire,NULL,500,500,8000,7500
17-0007657,2017,Spring,3/15/2017,1329 SALE Louisville KY 40215,Structure Fire,111,111 - Building fire,500,0,500,47600,47100
17-0008017,2017,Spring,3/19/2017,600 WIMBLETON 2 Louisville KY 40218,Structure Fire,113,"113 - Cooking fire, confined to container",0,200,200,1000000,999800
17-0008051,2017,Spring,3/19/2017,2708 W CHESTNUT Louisville KY 40211,Structure Fire,111,111 - Building fire,500,15000,15500,15000,-500
17-0008047,2017,Spring,3/19/2017,S 11TH Louisville KY 40210,Structure Fire,111,111 - Building fire,0,150000,150000,150000,0
17-0008057,2017,Spring,3/19/2017,906 CECIL Louisville KY 40211,Structure Fire,111,111 - Building fire,NULL,15000,15000,20000,5000
17-0008119,2017,Spring,3/20/2017,S 1ST Louisville KY 40203,Vehicle Fire,131,131 - Passenger vehicle fire,100,15000,15100,15000,-100
17-0008205,2017,Spring,3/21/2017,1101 BARDSTOWN Louisville KY 40204,Vehicle Fire,131,131 - Passenger vehicle fire,NULL,100,100,500,400
17-0008298,2017,Spring,3/21/2017,3115 PORTLAND Louisville KY 40212,Structure Fire,111,111 - Building fire,800,1000,1800,29230,27430
17-0008314,2017,Spring,3/22/2017,3700 W WHEATMORE Louisville KY 40215,FALSE,142,142 - Brush or brush-and-grass mixture fire,100,NULL,100,1000000,999900
17-0008352,2017,Spring,3/22/2017,3428 RIVER PARK Louisville KY 40211,Structure Fire,111,111 - Building fire,5000,10000,15000,41900,26900
17-0008436,2017,Spring,3/23/2017,2644 ALGONQUIN Louisville KY 40210,Vehicle Fire,131,131 - Passenger vehicle fire,100,800,900,800,-100
17-0008438,2017,Spring,3/23/2017,1138 S 28TH Louisville KY 40211,Structure Fire,111,111 - Building fire,15000,37300,52300,37300,-15000
17-0008463,2017,Spring,3/23/2017,1628 ARLING Louisville KY 40215,Structure Fire,111,111 - Building fire,5000,20000,25000,65000,40000
17-0008574,2017,Spring,3/24/2017,1818 W JEFFERSON Louisville KY 40203,Structure Fire,111,111 - Building fire,0,1000,1000,29530,28530
17-0008671,2017,Spring,3/25/2017,3507 W MUHAMMAD ALI Louisville KY 40212,Structure Fire,111,111 - Building fire,3000,5000,8000,27000,19000
17-0008726,2017,Spring,3/26/2017,118 N EWING Louisville KY 40206,Structure Fire,111,111 - Building fire,15000,50000,65000,192990,127990
17-0008774,2017,Spring,3/26/2017,2203 DATE Louisville KY 40210,Structure Fire,111,111 - Building fire,NULL,15000,15000,30000,15000
17-0008783,2017,Spring,3/26/2017,2822 GARFIELD Louisville KY 40212,Structure Fire,111,111 - Building fire,1200,24000,25200,24000,-1200
17-0009182,2017,Spring,3/30/2017,4015 GRAND Louisville KY 40211,Structure Fire,113,"113 - Cooking fire, confined to container",20,0,20,40000,39980
17-0009192,2017,Spring,3/30/2017,1777 WILSON Louisville KY 40210,Vehicle Fire,131,131 - Passenger vehicle fire,0,2000,2000,8000,6000
17-0009223,2017,Spring,3/30/2017,I264W @ I65 City of Louisville KY 40213,Vehicle Fire,131,131 - Passenger vehicle fire,NULL,4500,4500,4500,0
17-0009365,2017,Spring,4/1/2017,665 S 27TH Louisville KY 40211,Structure Fire,111,111 - Building fire,1000,500,1500,20770,19270
17-0009486,2017,Spring,4/2/2017,4516 BREWSTER Louisville KY 40211,Structure Fire,111,111 - Building fire,200,1000,1200,60000,58800
17-0009487,2017,Spring,4/2/2017,3532 NORBOURNE STM KY 40207,Structure Fire,118,"118 - Trash or rubbish fire, contained",250,1000,1250,20000,18750
17-0009528,2017,Spring,4/3/2017,2019 BANK Louisville KY 40203,Structure Fire,111,111 - Building fire,0,38620,38620,38620,0
17-0009589,2017,Spring,4/3/2017,3104 COMMANDER Louisville KY 40220,Vehicle Fire,131,131 - Passenger vehicle fire,NULL,100,100,5000,4900
17-0009528,2017,Spring,4/3/2017,2023 Bank City of Louisville KY 40203,Structure Fire,111,111 - Building fire,5000,2000,7000,47980,40980
17-0009528,2017,Spring,4/3/2017,2017 Bank City of Louisville KY 40203,Structure Fire,111,111 - Building fire,1000,2000,3000,61590,58590
17-0009858,2017,Spring,4/6/2017,2532 W BURNETT Louisville KY 40210,Structure Fire,111,111 - Building fire,NULL,400,400,2000,1600
17-0009931,2017,Spring,4/7/2017,1329 LILLIAN Louisville KY 40208,Structure Fire,111,111 - Building fire,200,400,600,26650,26050
17-0009933,2017,Spring,4/7/2017,2129 BOLLING Louisville KY 40210,Structure Fire,113,"113 - Cooking fire, confined to container",1000,NULL,1000,75000,74000
17-0009983,2017,Spring,4/8/2017,2200 BROWNSBORO Louisville KY 40206,Vehicle Fire,130,"130 - Mobile property (vehicle) fire, other",1000,2000,3000,2500,-500
17-0010053,2017,Spring,4/8/2017,Riverpark City of Louisville KY 40211,Vehicle Fire,131,131 - Passenger vehicle fire,0,6000,6000,6000,0
17-0010128,2017,Spring,4/9/2017,409 W TENNY Louisville KY 40214,Outside Fire,160,"160 - Special outside fire, other",0,500,500,80000,79500
17-0010193,2017,Spring,4/10/2017,1206 S PRESTON Louisville KY 40203,Structure Fire,111,111 - Building fire,0,10000,10000,45000,35000
17-0010271,2017,Spring,4/10/2017,W BROADWAY Louisville KY 40211,Outside Fire,151,"151 - Outside rubbish, trash or waste fire",6000,0,6000,150000,144000
17-0010277,2017,Spring,4/10/2017,3044 W BROADWAY Louisville KY 40211,Outside Fire,161,161 - Outside storage fire,2000,2000,4000,100000,96000
17-0010291,2017,Spring,4/10/2017,2435 ELLIOTT Louisville KY 40211,Structure Fire,111,111 - Building fire,0,10000,10000,10000,0
17-0010295,2017,Spring,4/10/2017,528 DRESDEN Louisville KY 40215,Structure Fire,111,111 - Building fire,10000,50000,60000,85000,25000
17-0010297,2017,Spring,4/10/2017,315 IROQUOIS GARDENS Louisville KY 40214,Structure Fire,111,111 - Building fire,500,0,500,400000,399500
17-0010299,2017,Spring,4/10/2017,W OAK Louisville KY 40210,Vehicle Fire,131,131 - Passenger vehicle fire,NULL,1000,1000,2000,1000
17-0010302,2017,Spring,4/10/2017,2612 MONTGOMERY Louisville KY 40212,Structure Fire,111,111 - Building fire,1000,15000,16000,15000,-1000
17-0010305,2017,Spring,4/10/2017,S 28TH Louisville KY 40211,Outside Fire,160,"160 - Special outside fire, other",0,20,20,20,0
17-0010306,2017,Spring,4/10/2017,LOUIS COLEMAN JR Louisville KY 40212,Vehicle Fire,131,131 - Passenger vehicle fire,NULL,10000,10000,10000,0
17-0010295,2017,Spring,4/10/2017,526 Dresden City of Louisville KY 40215,Structure Fire,111,111 - Building fire,5000,10000,15000,85000,70000
17-0010483,2017,Spring,4/12/2017,S 16TH Louisville KY 40210,Vehicle Fire,131,131 - Passenger vehicle fire,NULL,300,300,500,200
17-0010512,2017,Spring,4/12/2017,2014 PORTLAND Louisville KY 40203,Structure Fire,111,111 - Building fire,0,15000,15000,57570,42570
17-0010613,2017,Spring,4/13/2017,2368 FRANKFORT Louisville KY 40206,Vehicle Fire,131,131 - Passenger vehicle fire,NULL,2000,2000,2000,0
17-0010651,2017,Spring,4/13/2017,1103 LINCOLN Louisville KY 40208,Vehicle Fire,131,131 - Passenger vehicle fire,NULL,2000,2000,2000,0
17-0010673,2017,Spring,4/13/2017,2910 CLEVELAND Louisville KY 40206,Structure Fire,111,111 - Building fire,500,500,1000,150000,149000
17-0010613,2017,Spring,4/13/2017,2368 Frankfort City of Louisville KY 40206,Vehicle Fire,131,131 - Passenger vehicle fire,250,2000,2250,2000,-250
17-0010693,2017,Spring,4/14/2017,3400 BANK Louisville KY 40212,Structure Fire,123,"123 - Fire in portable building, fixed location",1000,3000,4000,20000,16000
17-0010813,2017,Spring,4/15/2017,Pee Wee Reese City of Louisville KY 40205,Vehicle Fire,131,131 - Passenger vehicle fire,100,4000,4100,4000,-100
17-0010907,2017,Spring,4/15/2017,628 E OAK Louisville KY 40203,Structure Fire,111,111 - Building fire,10000,30000,40000,57000,17000
17-0011004,2017,Spring,4/16/2017,4829 SOUTHERN Louisville KY 40214,Structure Fire,111,111 - Building fire,10000,10000,20000,151000,131000
17-0011042,2017,Spring,4/17/2017,1132 SAMUEL Louisville KY 40204,Structure Fire,111,111 - Building fire,500,5000,5500,120000,114500
17-0011042,2017,Spring,4/17/2017,1134 Samuel Louisville KY 40204,Structure Fire,111,111 - Building fire,0,500,500,150000,149500
17-0011101,2017,Spring,4/17/2017,3018 ELEANOR Louisville KY 40205,Structure Fire,111,111 - Building fire,10000,5000,15000,174780,159780
17-0011316,2017,Spring,4/19/2017,2240 W JEFFERSON 2 Louisville KY 40212,Vehicle Fire,131,131 - Passenger vehicle fire,100,2200,2300,2400,100
17-0011295,2017,Spring,4/19/2017,130 S 44TH Louisville KY 40212,Structure Fire,111,111 - Building fire,20000,36300,56300,36300,-20000
17-0011438,2017,Spring,4/20/2017,SHAMROCK WYND Louisville KY 40212,FALSE,151,"151 - Outside rubbish, trash or waste fire",NULL,500,500,50000,49500
17-0011439,2017,Spring,4/20/2017,224 GLENDORA Louisville KY 40212,FALSE,150,"150 - Outside rubbish fire, other",NULL,500,500,500,0
17-0011440,2017,Spring,4/20/2017,1703 LANG Louisville KY 40211,Structure Fire,111,111 - Building fire,5000,25000,30000,61330,31330
17-0011709,2017,Spring,4/23/2017,S I-71 S South City of Louisville KY 40206,Vehicle Fire,131,131 - Passenger vehicle fire,40,750,790,750,-40
17-0011718,2017,Spring,4/23/2017,5440 MITSCHER Louisville KY 40214,Outside Fire,154,154 - Dumpster or other outside trash receptacle fire,0,100,100,500,400
17-0011636,2017,Spring,4/23/2017,2333 DUNCAN Louisville KY 40212,Structure Fire,111,111 - Building fire,70,1000,1070,45000,43930
17-0011678,2017,Spring,4/23/2017,510 W BROADWAY Louisville KY 40202,Structure Fire,111,111 - Building fire,100,1000,1100,3000000,2998900
17-0011820,2017,Spring,4/24/2017,3321 GILLIGAN Louisville KY 40212,Vehicle Fire,131,131 - Passenger vehicle fire,0,25376,25376,25376,0
17-0012078,2017,Spring,4/27/2017,1391 TYLER PARK Louisville KY 40204,Structure Fire,111,111 - Building fire,20000,80000,100000,600000,500000
17-0012103,2017,Spring,4/27/2017,1518 BEECH Louisville KY 40211,Structure Fire,111,111 - Building fire,500,3000,3500,33500,30000
17-0012277,2017,Spring,4/29/2017,BRINKEY 8 Louisville KY 40218,Structure Fire,113,"113 - Cooking fire, confined to container",100,0,100,435070,434970
17-0012359,2017,Spring,4/30/2017,S JACKSON Louisville KY 40208,Vehicle Fire,131,131 - Passenger vehicle fire,NULL,10000,10000,15000,5000
17-0012436,2017,Summer,5/1/2017,400 W Southside Louisville KY 40214,Structure Fire,111,111 - Building fire,10000,20000,30000,102900,72900
17-0012542,2017,Summer,5/2/2017,2322 LYTLE Louisville KY 40212,Structure Fire,111,111 - Building fire,500,4500,5000,24500,19500
17-0012602,2017,Summer,5/2/2017,132 N SHAWNEE Louisville KY 40212,Structure Fire,111,111 - Building fire,12000,30000,42000,53100,11100
17-0012681,2017,Summer,5/3/2017,2638 WOODLAND Louisville KY 40211,Vehicle Fire,131,131 - Passenger vehicle fire,NULL,5500,5500,7000,1500
17-0012715,2017,Summer,5/3/2017,JAEGER Louisville KY 40205,Vehicle Fire,131,131 - Passenger vehicle fire,NULL,1500,1500,1500,0
17-0012942,2017,Summer,5/6/2017,1228 MORGAN Louisville KY 40213,Structure Fire,111,111 - Building fire,5000,10000,15000,10000,-5000
17-0012964,2017,Summer,5/6/2017,Northwestern City of Louisville KY 40212,Vehicle Fire,131,131 - Passenger vehicle fire,NULL,1000,1000,1000,0
17-0012942,2017,Summer,5/6/2017,1226 MORGAN City of Louisville KY 40213,Structure Fire,111,111 - Building fire,0,5000,5000,64610,59610
17-0013011,2017,Summer,5/7/2017,1118 LONGFIELD Louisville KY 40215,Vehicle Fire,131,131 - Passenger vehicle fire,500,5000,5500,27000,21500
17-0013012,2017,Summer,5/7/2017,264 East bound Louisville KY 40218,Vehicle Fire,131,131 - Passenger vehicle fire,200,3000,3200,3000,-200
17-0013065,2017,Summer,5/7/2017,1934 RUTHERFORD Louisville KY 40205,Outside Fire,154,154 - Dumpster or other outside trash receptacle fire,100,0,100,275000,274900
17-0013151,2017,Summer,5/8/2017,1515 OLEANDA Louisville KY 40215,Structure Fire,111,111 - Building fire,NULL,20000,20000,100000,80000
17-0013285,2017,Summer,5/9/2017,I-264 East Louisville KY 40220,Vehicle Fire,130,"130 - Mobile property (vehicle) fire, other",0,8000,8000,43000,35000
17-0013324,2017,Summer,5/9/2017,1430 BERRY Louisville KY 40215,Structure Fire,113,"113 - Cooking fire, confined to container",300,300,600,300,-300
17-0013446,2017,Summer,5/10/2017,432 E JEFFERSON Louisville KY 40202,Structure Fire,111,111 - Building fire,200,0,200,6270000,6269800
17-0013463,2017,Summer,5/11/2017,432 E JEFFERSON Louisville KY 40202,Structure Fire,111,111 - Building fire,100,0,100,6270000,6269900
17-0013604,2017,Summer,5/12/2017,81 COLLEGE Louisville KY 40203,Structure Fire,111,111 - Building fire,1500,10000,11500,14810,3310
17-0013706,2017,Summer,5/13/2017,1200 TENNESSEE Louisville KY 40208,Structure Fire,111,111 - Building fire,50,0,50,5000,4950
17-0013786,2017,Summer,5/14/2017,2308 GRIFFITHS Louisville KY 40212,Vehicle Fire,131,131 - Passenger vehicle fire,0,1400,1400,1600,200
17-0013808,2017,Summer,5/14/2017,1624 GALLAGHER Louisville KY 40210,Structure Fire,111,111 - Building fire,NULL,10000,10000,13290,3290
17-0013816,2017,Summer,5/14/2017,4102 LEE City of Louisville KY 40214,Structure Fire,111,111 - Building fire,0,200,200,500,300
17-0013904,2017,Summer,5/15/2017,2608 W JEFFERSON Louisville KY 40212,Structure Fire,111,111 - Building fire,1000,5000,6000,35360,29360
17-0013910,2017,Summer,5/15/2017,3211 MID DALE Louisville KY 40220,Vehicle Fire,131,131 - Passenger vehicle fire,NULL,100,100,7000,6900
17-0013908,2017,Summer,5/15/2017,1216 BICKNELL Louisville KY 40215,Structure Fire,111,111 - Building fire,10000,65000,75000,65000,-10000
17-0013995,2017,Summer,5/16/2017,2502 PRESTON Louisville KY 40217,Vehicle Fire,130,"130 - Mobile property (vehicle) fire, other",250,2000,2250,2000,-250
17-0014016,2017,Summer,5/16/2017,TAYLOR Louisville KY 40208,Vehicle Fire,131,131 - Passenger vehicle fire,100,1450,1550,1500,-50
17-0014088,2017,Summer,5/17/2017,906 PLACE ROUGE Louisville KY 40203,Outside Fire,160,"160 - Special outside fire, other",100,0,100,100,0
17-0014093,2017,Summer,5/17/2017,4205 W MARKET Louisville KY 40212,Structure Fire,111,111 - Building fire,3500,40000,43500,70000,26500
17-0014122,2017,Summer,5/17/2017,I65 South City of Louisville KY 40213,Vehicle Fire,131,131 - Passenger vehicle fire,0,500,500,2500,2000
17-0014217,2017,Summer,5/18/2017,310 S HANCOCK Louisville KY 40202,Structure Fire,111,111 - Building fire,3000,150000,153000,5000000,4847000
17-0014396,2017,Summer,5/20/2017,3829 HALE Louisville KY 40211,Structure Fire,111,111 - Building fire,3000,10000,13000,70000,57000
17-0014418,2017,Summer,5/20/2017,W MARKET Louisville KY 40212,Vehicle Fire,131,131 - Passenger vehicle fire,0,7500,7500,15000,7500
17-0014436,2017,Summer,5/20/2017,3300 LESTER Louisville KY 40215,Vehicle Fire,131,131 - Passenger vehicle fire,2000,4000,6000,4000,-2000
17-0014648,2017,Summer,5/22/2017,1120 SAMUEL Louisville KY 40204,FALSE,154,154 - Dumpster or other outside trash receptacle fire,NULL,500,500,2500,2000
17-0014650,2017,Summer,5/22/2017,906 ELLISON Louisville KY 40204,Vehicle Fire,131,131 - Passenger vehicle fire,0,2500,2500,2500,0
17-0014693,2017,Summer,5/22/2017,3505 WHEELER Louisville KY 40215,Structure Fire,111,111 - Building fire,10000,20000,30000,50000,20000
17-0014651,2017,Summer,5/22/2017,914 E Oak City of Louisville KY 40204,Structure Fire,111,111 - Building fire,1000,8000,9000,38850,29850
17-0014729,2017,Summer,5/23/2017,3778 LEXINGTON Louisville KY 40207,FALSE,324,324 - Motor vehicle accident with no injuries.,0,600,600,350000,349400
17-0014730,2017,Summer,5/23/2017,2900 SPRINGDALE Louisville KY 40206,Structure Fire,113,"113 - Cooking fire, confined to container",500,100,600,500000,499400
17-0014799,2017,Summer,5/24/2017,800 FLORHAM 103 Louisville KY 40208,Structure Fire,111,111 - Building fire,0,1000,1000,1000000,999000
17-0014943,2017,Summer,5/25/2017,800 S 38TH Louisville KY 40211,Structure Fire,111,111 - Building fire,NULL,2000,2000,42360,40360
17-0014948,2017,Summer,5/25/2017,S 3RD Louisville KY 40208,Vehicle Fire,131,131 - Passenger vehicle fire,0,1000,1000,1000,0
17-0015081,2017,Summer,5/26/2017,1114 W MUHAMMAD ALI Louisville KY 40203,Structure Fire,111,111 - Building fire,1500,1500,3000,2751930,2748930
17-0015097,2017,Summer,5/26/2017,2716 BANK Louisville KY 40212,Structure Fire,111,111 - Building fire,0,5000,5000,5000,0
17-0015347,2017,Summer,5/29/2017,1219 BELMAR Louisville KY 40213,Structure Fire,111,111 - Building fire,3500,10000,13500,120000,106500
17-0015379,2017,Summer,5/29/2017,7TH STREET Louisville KY 40216,Vehicle Fire,131,131 - Passenger vehicle fire,0,1000,1000,4000,3000
17-0015423,2017,Summer,5/30/2017,1520 ARLING Louisville KY 40215,Structure Fire,111,111 - Building fire,5000,20000,25000,75000,50000
17-0015530,2017,Summer,5/31/2017,3240 W Jefferson Louisville KY 40212,Vehicle Fire,131,131 - Passenger vehicle fire,NULL,9700,9700,9700,0
17-0015582,2017,Summer,5/31/2017,324 E MAIN 521 City of Louisville KY 40202,Structure Fire,113,"113 - Cooking fire, confined to container",5000,NULL,5000,5000,0
17-0015616,2017,Summer,6/1/2017,4001 LENTZ Louisville KY 40215,Structure Fire,111,111 - Building fire,5000,10000,15000,60000,45000
17-0015670,2017,Summer,6/1/2017,Interstate 64 City of Louisville KY 40206,Vehicle Fire,131,131 - Passenger vehicle fire,1000,8000,9000,8000,-1000
17-0015953,2017,Summer,6/4/2017,N 38TH Louisville KY 40212,Vehicle Fire,131,131 - Passenger vehicle fire,NULL,6600,6600,6600,0
17-0016040,2017,Summer,6/4/2017,1730 W ST CATHERINE Louisville KY 40210,FALSE,311,"311 - Medical assist, assist EMS crew",0,10000,10000,10000,0
17-0016055,2017,Summer,6/4/2017,S 23RD Louisville KY 40210,Vehicle Fire,131,131 - Passenger vehicle fire,0,10000,10000,10000,0
17-0016288,2017,Summer,6/7/2017,3900 POPLAR LEVEL Louisville KY 40213,Structure Fire,111,111 - Building fire,0,15000,15000,130000,115000
17-0016346,2017,Summer,6/7/2017,3100 CLINTON 6 Shively KY 40216,Structure Fire,111,111 - Building fire,5000,2000,7000,1746000,1739000
17-0016377,2017,Summer,6/8/2017,1929 PEABODY 6 Louisville KY 40218,Structure Fire,111,111 - Building fire,250,1000,1250,200000,198750
17-0016386,2017,Summer,6/8/2017,4010 FRANKLIN Louisville KY 40213,Vehicle Fire,131,131 - Passenger vehicle fire,0,4000,4000,10000,6000
17-0016457,2017,Summer,6/8/2017,1826 jefferson Louisville KY 40203,Structure Fire,111,111 - Building fire,0,10000,10000,55290,45290
17-0016457,2017,Summer,6/8/2017,1830 W JEFFERSON Louisville KY 40203,Structure Fire,111,111 - Building fire,NULL,90000,90000,90000,0
17-0016473,2017,Summer,6/9/2017,321 25 Louisville KY 40212,Structure Fire,111,111 - Building fire,0,17900,17900,17900,0
17-0016481,2017,Summer,6/9/2017,1718 W JEFFERSON Louisville KY 40203,FALSE,162,162 - Outside equipment fire,NULL,1200,1200,1200,0
17-0016559,2017,Summer,6/10/2017,215 SHAWNEE Louisville KY 40212,FALSE,151,"151 - Outside rubbish, trash or waste fire",NULL,100,100,100,0
17-0016577,2017,Summer,6/10/2017,3408 W MAIN Louisville KY 40212,Structure Fire,111,111 - Building fire,5000,20000,25000,31630,6630
17-0016581,2017,Summer,6/10/2017,432 S 16TH Louisville KY 40203,Structure Fire,111,111 - Building fire,NULL,500,500,54000,53500
17-0016770,2017,Summer,6/12/2017,2033 BANK Louisville KY 40203,Structure Fire,111,111 - Building fire,NULL,20000,20000,54160,34160
17-0016871,2017,Summer,6/12/2017,EASTERN Louisville KY 40217,Vehicle Fire,131,131 - Passenger vehicle fire,NULL,2000,2000,2000,0
17-0016954,2017,Summer,6/13/2017,N 16TH Louisville KY 40203,Outside Fire,151,"151 - Outside rubbish, trash or waste fire",0,100,100,100,0
17-0016984,2017,Summer,6/13/2017,511 S 5TH Louisville KY 40202,Structure Fire,111,111 - Building fire,1000,1000,2000,8800000,8798000
17-0017098,2017,Summer,6/14/2017,I-264 East City of Louisville KY 40205,Vehicle Fire,130,"130 - Mobile property (vehicle) fire, other",0,4000,4000,17000,13000
17-0017132,2017,Summer,6/15/2017,3321 RUDD Louisville KY 40212,Structure Fire,111,111 - Building fire,1,37030,37031,37030,-1
17-0017132,2017,Summer,6/15/2017,815 N 34th City of Louisville KY 40212,Structure Fire,111,111 - Building fire,1,2000,2001,15000,12999
17-0017132,2017,Summer,6/15/2017,3317 Rudd City of Louisville KY 40212,Structure Fire,111,111 - Building fire,2000,15000,17000,48140,31140
17-0017268,2017,Summer,6/16/2017,4501 W BROADWAY Louisville KY 40211,Vehicle Fire,131,131 - Passenger vehicle fire,NULL,10000,10000,10000,0
17-0017292,2017,Summer,6/16/2017,3012 NADINA Louisville KY 40220,Structure Fire,111,111 - Building fire,10000,40000,50000,160000,110000
17-0017660,2017,Summer,6/19/2017,3700 W WHEATMORE 520 Louisville KY 40215,Structure Fire,111,111 - Building fire,1000,3000,4000,8000000,7996000
17-0017670,2017,Summer,6/19/2017,2118 DATE Louisville KY 40210,Structure Fire,111,111 - Building fire,10000,15000,25000,25000,0
17-0017700,2017,Summer,6/19/2017,1935 BLUEGRASS Louisville KY 40216,Vehicle Fire,131,131 - Passenger vehicle fire,NULL,2000,2000,8500,6500
17-0017757,2017,Summer,6/19/2017,304 N 17TH City of Louisville KY 40203,Structure Fire,111,111 - Building fire,500,1000,1500,20000,18500
17-0017760,2017,Summer,6/19/2017,2308 W MARKET Louisville KY 40212,Structure Fire,111,111 - Building fire,0,700,700,33700,33000
17-0017948,2017,Summer,6/21/2017,739 E KENTUCKY Louisville KY 40203,Structure Fire,111,111 - Building fire,100,1000,1100,2000,900
17-0017965,2017,Summer,6/21/2017,600 N 27TH 105 Louisville KY 40212,Structure Fire,113,"113 - Cooking fire, confined to container",NULL,200,200,200,0
17-0017991,2017,Summer,6/22/2017,W MARKET Louisville KY 40212,FALSE,151,"151 - Outside rubbish, trash or waste fire",NULL,50,50,50,0
17-0018076,2017,Summer,6/22/2017,3708 W BROADWAY Louisville KY 40211,Structure Fire,111,111 - Building fire,0,500,500,82370,81870
17-0018145,2017,Summer,6/23/2017,205 S PRESTON Louisville KY 40202,Structure Fire,111,111 - Building fire,NULL,1000,1000,240000,239000
17-0018185,2017,Summer,6/23/2017,223 N 33RD Louisville KY 40212,Structure Fire,111,111 - Building fire,0,500,500,500,0
17-0018211,2017,Summer,6/23/2017,MALCOLM Louisville KY 40215,Structure Fire,111,111 - Building fire,5000,5000,10000,12000,2000
17-0018279,2017,Summer,6/24/2017,822 SUTCLIFFE Louisville KY 40211,Structure Fire,113,"113 - Cooking fire, confined to container",500,0,500,90000,89500
17-0018378,2017,Summer,6/25/2017,1782 DIXDALE Louisville KY 40210,Structure Fire,111,111 - Building fire,10000,20000,30000,60000,30000
17-0018694,2017,Summer,6/27/2017,1519 W JEFFERSON City of Louisville KY 40203,Structure Fire,111,111 - Building fire,1000,1000,2000,2000,0
17-0018581,2017,Summer,6/27/2017,310 N 19TH Louisville KY 40203,Vehicle Fire,131,131 - Passenger vehicle fire,0,5252,5252,5252,0
17-0018804,2017,Summer,6/28/2017,1100 TREVILIAN Louisville KY 40213,Vehicle Fire,131,131 - Passenger vehicle fire,0,1300,1300,1300,0
17-0018915,2017,Summer,6/29/2017,1039 WAGNER Louisville KY 40217,Structure Fire,113,"113 - Cooking fire, confined to container",30,NULL,30,99000,98970
17-0018914,2017,Summer,6/29/2017,3501 CANE RUN Louisville KY 40210,Structure Fire,111,111 - Building fire,5000,202980,207980,202980,-5000
17-0019095,2017,Summer,6/30/2017,1527 ANNA Louisville KY 40216,Structure Fire,111,111 - Building fire,1000,2000,3000,140000,137000
17-0019268,2017,Summer,7/2/2017,I-65 North City of Louisville KY 40217,Vehicle Fire,131,131 - Passenger vehicle fire,0,12000,12000,12000,0
17-0019352,2017,Summer,7/2/2017,2001 TYRONE Louisville KY 40218,Structure Fire,113,"113 - Cooking fire, confined to container",200,NULL,200,90000,89800
17-0019378,2017,Summer,7/2/2017,Seneca Park Dr City of Louisville KY 40205,Vehicle Fire,131,131 - Passenger vehicle fire,NULL,7000,7000,7000,0
17-0019482,2017,Summer,7/3/2017,I65 City of Louisville KY 40202,Vehicle Fire,131,131 - Passenger vehicle fire,NULL,15000,15000,15000,0
17-0019583,2017,Summer,7/4/2017,3217 UTAH 1 City of Louisville KY 40215,Structure Fire,111,111 - Building fire,0,100,100,300000,299900
17-0019593,2017,Summer,7/4/2017,425 N 26TH Louisville KY 40212,Vehicle Fire,131,131 - Passenger vehicle fire,100,2000,2100,2000,-100
17-0019685,2017,Summer,7/5/2017,722 ROSELANE Louisville KY 40203,Vehicle Fire,131,131 - Passenger vehicle fire,0,5000,5000,5000,0
17-0019739,2017,Summer,7/5/2017,2026 LYTLE Louisville KY 40203,Outside Fire,150,"150 - Outside rubbish fire, other",0,100,100,100,0
17-0019893,2017,Summer,7/6/2017,3801 MAMARONECK Louisville KY 40218,Structure Fire,111,111 - Building fire,NULL,250,250,133810,133560
17-0019960,2017,Summer,7/7/2017,197 CORAL City of Louisville KY 40206,Structure Fire,111,111 - Building fire,2500,15000,17500,260000,242500
17-0019961,2017,Summer,7/7/2017,911 GRADE Louisville KY 40213,Vehicle Fire,131,131 - Passenger vehicle fire,500,2000,2500,2000,-500
17-0020054,2017,Summer,7/7/2017,1630 S 11TH Louisville KY 40210,Vehicle Fire,131,131 - Passenger vehicle fire,NULL,15000,15000,15000,0
17-0020211,2017,Summer,7/9/2017,1183 LINCOLN Louisville KY 40208,Structure Fire,111,111 - Building fire,200,300,500,57290,56790
17-0020230,2017,Summer,7/9/2017,2215 THISTLEDAWN Shively KY 40216,Structure Fire,111,111 - Building fire,10000,15000,25000,60000,35000
17-0020262,2017,Summer,7/9/2017,2640 HALE Louisville KY 40211,Vehicle Fire,131,131 - Passenger vehicle fire,200,500,700,500,-200
17-0020300,2017,Summer,7/10/2017,550 S 8TH 535 Louisville KY 40203,Vehicle Fire,131,131 - Passenger vehicle fire,NULL,5000,5000,20000,15000
17-0020438,2017,Summer,7/11/2017,1403 SALE Louisville KY 40215,Structure Fire,111,111 - Building fire,5000,10000,15000,10000,-5000
17-0020541,2017,Summer,7/11/2017,CECIL Louisville KY 40211,Vehicle Fire,131,131 - Passenger vehicle fire,NULL,2500,2500,2500,0
17-0020558,2017,Summer,7/12/2017,1103 TENNESSEE Louisville KY 40208,Structure Fire,111,111 - Building fire,5000,20000,25000,31510,6510
17-0020627,2017,Summer,7/12/2017,I-264 East City of Louisville KY 40211,Vehicle Fire,131,131 - Passenger vehicle fire,NULL,2500,2500,2500,0
17-0020763,2017,Summer,7/13/2017,3620 GLENCREEK Louisville KY 40218,Structure Fire,111,111 - Building fire,500,5000,5500,160000,154500
17-0020903,2017,Summer,7/14/2017,S 6TH Louisville KY 40202,Vehicle Fire,131,131 - Passenger vehicle fire,0,500,500,500,0
17-0020929,2017,Summer,7/14/2017,1708 GALLAGHER Louisville KY 40210,Vehicle Fire,131,131 - Passenger vehicle fire,NULL,2000,2000,2000,0
17-0020929,2017,Summer,7/14/2017,1708 Gallagher Louisville KY 40210,Structure Fire,111,111 - Building fire,NULL,800,800,28000,27200
17-0020956,2017,Summer,7/14/2017,826 DRESDEN Louisville KY 40215,Structure Fire,111,111 - Building fire,15000,50000,65000,53340,-11660
17-0020956,2017,Summer,7/14/2017,824 Dresden City of Louisville KY 40215,Structure Fire,111,111 - Building fire,3000,5000,8000,80000,72000
17-0020956,2017,Summer,7/14/2017,828 Dresden City of Louisville KY 40215,Structure Fire,111,111 - Building fire,8000,50000,58000,52000,-6000
17-0021128,2017,Summer,7/16/2017,3708 POWELL Louisville KY 40215,Vehicle Fire,131,131 - Passenger vehicle fire,50,1000,1050,1000,-50
17-0021146,2017,Summer,7/16/2017,131 RIVER Louisville KY 40202,Structure Fire,112,112 - Fires in structure other than in a building,NULL,500,500,10000,9500
17-0021243,2017,Summer,7/17/2017,S SHELBY Louisville KY 40202,Vehicle Fire,131,131 - Passenger vehicle fire,10000,10000,20000,10000,-10000
17-0021254,2017,Summer,7/17/2017,I264E City of Louisville KY 40213,Vehicle Fire,131,131 - Passenger vehicle fire,0,4000,4000,7000,3000
17-0021292,2017,Summer,7/17/2017,1043 BARDSTOWN Louisville KY 40204,Structure Fire,111,111 - Building fire,100,0,100,2000,1900
17-0021395,2017,Summer,7/18/2017,S 6TH Louisville KY 40202,Outside Fire,154,154 - Dumpster or other outside trash receptacle fire,0,20,20,20,0
17-0021619,2017,Summer,7/20/2017,1010 ALTA VISTA Louisville KY 40205,Structure Fire,111,111 - Building fire,100000,300000,400000,643330,243330
17-0021664,2017,Summer,7/20/2017,I 264 West City of Louisville KY 40209,Vehicle Fire,131,131 - Passenger vehicle fire,0,3500,3500,3500,0
17-0021693,2017,Summer,7/21/2017,3912 W BROADWAY Louisville KY 40211,Vehicle Fire,131,131 - Passenger vehicle fire,0,2500,2500,2500,0
17-0021738,2017,Summer,7/21/2017,1604 BONNYCASTLE Louisville KY 40205,Vehicle Fire,131,131 - Passenger vehicle fire,NULL,1574,1574,1574,0
17-0021856,2017,Summer,7/22/2017,1210 TENNESSEE Louisville KY 40208,Structure Fire,111,111 - Building fire,0,50000,50000,70000,20000
17-0021861,2017,Summer,7/22/2017,1749 W ORMSBY Louisville KY 40210,Vehicle Fire,131,131 - Passenger vehicle fire,0,3300,3300,3800,500
17-0021856,2017,Summer,7/22/2017,1208 Tennessee Louisville KY 40208,Structure Fire,111,111 - Building fire,0,5000,5000,70000,65000
17-0021856,2017,Summer,7/22/2017,1212 Tennessee City of Louisville KY 40208,Structure Fire,111,111 - Building fire,0,5000,5000,70000,65000
17-0022207,2017,Summer,7/24/2017,2018 PEABODY Louisville KY 40218,Structure Fire,111,111 - Building fire,NULL,500,500,200000,199500
17-0022229,2017,Summer,7/25/2017,29 NICHOLS Louisville KY 40215,Structure Fire,111,111 - Building fire,2000,5000,7000,200000,193000
17-0022323,2017,Summer,7/25/2017,947 S 7TH Louisville KY 40203,Structure Fire,111,111 - Building fire,0,1000,1000,29000,28000
17-0022353,2017,Summer,7/26/2017,2704 WYANDOTTE Louisville KY 40210,Structure Fire,111,111 - Building fire,5000,35000,40000,35000,-5000
17-0022360,2017,Summer,7/26/2017,4018 SOUTHERN Louisville KY 40214,Vehicle Fire,131,131 - Passenger vehicle fire,8000,1000,9000,8000,-1000
17-0022394,2017,Summer,7/26/2017,CRITTENDEN Louisville KY 40209,Vehicle Fire,131,131 - Passenger vehicle fire,100,1500,1600,3000,1400
17-0022592,2017,Summer,7/27/2017,4150 Schmitt City of Louisville KY 40218,Vehicle Fire,132,132 - Road freight or transport vehicle fire,1000,100000,101000,100000,-1000
17-0022592,2017,Summer,7/27/2017,4150 Schmitt City of Louisville KY 40218,Vehicle Fire,132,132 - Road freight or transport vehicle fire,1000,100000,101000,100000,-1000
17-0022592,2017,Summer,7/27/2017,4150 Schmitt City of Louisville KY 40218,Vehicle Fire,132,132 - Road freight or transport vehicle fire,0,5000,5000,100000,95000
17-0022496,2017,Summer,7/27/2017,GRINSTEAD Louisville KY 40204,Vehicle Fire,131,131 - Passenger vehicle fire,0,3000,3000,3000,0
17-0022578,2017,Summer,7/27/2017,2030 PORTLAND Louisville KY 40203,Structure Fire,111,111 - Building fire,0,1500,1500,28620,27120
17-0022597,2017,Summer,7/27/2017,6515 SIGNATURE Louisville KY 40213,Vehicle Fire,131,131 - Passenger vehicle fire,NULL,4000,4000,6000,2000
17-0022592,2017,Summer,7/27/2017,4150 SCHMITT Louisville KY 40213,Vehicle Fire,132,132 - Road freight or transport vehicle fire,500,250000,250500,320000,69500
17-0022618,2017,Summer,7/28/2017,E BROADWAY Louisville KY 40204,Vehicle Fire,131,131 - Passenger vehicle fire,100,1500,1600,1500,-100
17-0022775,2017,Summer,7/29/2017,1200 STORY Louisville KY 40206,Structure Fire,111,111 - Building fire,10000,250000,260000,1000000,740000
17-0022885,2017,Summer,7/30/2017,664 LOUIS COLEMAN JR Louisville KY 40211,Structure Fire,111,111 - Building fire,NULL,15000,15000,30000,15000
17-0022890,2017,Summer,7/30/2017,2033 BANK Louisville KY 40203,Structure Fire,111,111 - Building fire,0,500,500,15000,14500
17-0022942,2017,Summer,7/30/2017,645 S 41st City of Louisville KY 40211,Structure Fire,111,111 - Building fire,20000,1000,21000,20000,-1000
17-0023002,2017,Summer,7/31/2017,2122 CRITTENDEN Louisville KY 40217,Structure Fire,111,111 - Building fire,500,500,1000,500,-500
17-0023025,2017,Summer,7/31/2017,4121 PRESTON Louisville KY 40213,Vehicle Fire,130,"130 - Mobile property (vehicle) fire, other",200,5000,5200,5000,-200
17-0023035,2017,Summer,7/31/2017,I-65 S Louisville KY 40202,Vehicle Fire,132,132 - Road freight or transport vehicle fire,1000,5000,6000,150000,144000
17-0023069,2017,Summer,7/31/2017,2500 St. Cecilia Louisville KY 40212,Structure Fire,111,111 - Building fire,NULL,5000,5000,40520,35520
17-0023094,2017,Summer,7/31/2017,1935 GARDINER Louisville KY 40205,Vehicle Fire,131,131 - Passenger vehicle fire,NULL,1000,1000,1000,0
17-0023343,2017,Autumn,8/2/2017,1117 PLATO Louisville KY 40211,Structure Fire,111,111 - Building fire,1000,5000,6000,66530,60530
17-0023283,2017,Autumn,8/2/2017,2014 CHEROKEE Louisville KY 40204,Structure Fire,111,111 - Building fire,10000,112308,122308,1123080,1000772
17-0023424,2017,Autumn,8/3/2017,1109 LONGFIELD Louisville KY 40215,Structure Fire,111,111 - Building fire,5000,20000,25000,80000,55000
17-0023502,2017,Autumn,8/4/2017,530 LILLY Louisville KY 40217,Vehicle Fire,131,131 - Passenger vehicle fire,1000,4000,5000,5000,0
17-0023556,2017,Autumn,8/4/2017,3017 BOBOLINK Louisville KY 40217,Structure Fire,111,111 - Building fire,10000,30000,40000,140000,100000
17-0023663,2017,Autumn,8/5/2017,434 W MARKET Louisville KY 40202,Structure Fire,113,"113 - Cooking fire, confined to container",1000,0,1000,200000,199000
17-0023699,2017,Autumn,8/5/2017,3017 BITTEN Shively KY 40216,Structure Fire,111,111 - Building fire,10000,40000,50000,65320,15320
17-0023702,2017,Autumn,8/5/2017,1707 PATTON Louisville KY 40210,Vehicle Fire,131,131 - Passenger vehicle fire,NULL,2500,2500,2500,0
17-0023717,2017,Autumn,8/5/2017,1549 W MADISON Louisville KY 40203,FALSE,162,162 - Outside equipment fire,NULL,1000,1000,5000,4000
17-0023766,2017,Autumn,8/6/2017,3518 GEORGETOWN Louisville KY 40215,Structure Fire,111,111 - Building fire,5000,5000,10000,90000,80000
17-0023858,2017,Autumn,8/6/2017,201 N 19TH Louisville KY 40203,Structure Fire,111,111 - Building fire,0,5000,5000,41660,36660
17-0023982,2017,Autumn,8/8/2017,710 ZORN 8 Louisville KY 40206,Structure Fire,111,111 - Building fire,20000,50000,70000,334220,264220
17-0024063,2017,Autumn,8/8/2017,2901 ENGLEWOOD Louisville KY 40220,Structure Fire,113,"113 - Cooking fire, confined to container",500,1000,1500,180000,178500
17-0024009,2017,Autumn,8/8/2017,1400 STORY Louisville KY 40206,Structure Fire,116,"116 - Fuel burner/boiler malfunction, fire confined",500,1000,1500,2000,500
17-0024113,2017,Autumn,8/9/2017,Interstate 64 East Louisville KY 40202,Vehicle Fire,132,132 - Road freight or transport vehicle fire,50000,15000,65000,160000,95000
17-0024137,2017,Autumn,8/9/2017,3439 NEWBURG Louisville KY 40218,Structure Fire,111,111 - Building fire,5000,30000,35000,256000,221000
17-0024343,2017,Autumn,8/10/2017,1753 BOLLING Louisville KY 40210,Vehicle Fire,131,131 - Passenger vehicle fire,NULL,500,500,10000,9500
17-0024397,2017,Autumn,8/11/2017,1123 W WHITNEY Louisville KY 40215,FALSE,441,"441 - Heat from short circuit (wiring), defective/worn",0,500,500,100000,99500
17-0024440,2017,Autumn,8/11/2017,3909 JEWELL Louisville KY 40212,Structure Fire,111,111 - Building fire,200,1000,1200,35130,33930
17-0024538,2017,Autumn,8/12/2017,1269 S JACKSON Louisville KY 40203,FALSE,151,"151 - Outside rubbish, trash or waste fire",NULL,2000,2000,80000,78000
17-0024547,2017,Autumn,8/12/2017,5005 SOUTHSIDE Louisville KY 40214,Structure Fire,111,111 - Building fire,300,1000,1300,80340,79040
17-0024659,2017,Autumn,8/13/2017,3129 BANK Louisville KY 40212,Structure Fire,111,111 - Building fire,1000,5000,6000,50000,44000
17-0024667,2017,Autumn,8/13/2017,218 S SHAWNEE Louisville KY 40212,Structure Fire,111,111 - Building fire,500,4000,4500,4000,-500
17-0024659,2017,Autumn,8/13/2017,3125 Bank City of Louisville KY 40212,Structure Fire,111,111 - Building fire,NULL,1000,1000,32240,31240
17-0024750,2017,Autumn,8/13/2017,520 N 20TH Louisville KY 40203,Structure Fire,113,"113 - Cooking fire, confined to container",400,0,400,20000,19600
17-0024763,2017,Autumn,8/14/2017,5348 ROLLINGWOOD Louisville KY 40214,Structure Fire,111,111 - Building fire,1000,2000,3000,224640,221640
17-0024795,2017,Autumn,8/14/2017,4127 TAYLOR Louisville KY 40215,Vehicle Fire,131,131 - Passenger vehicle fire,0,2500,2500,3000,500
17-0024882,2017,Autumn,8/15/2017,1614 CYPRESS Louisville KY 40210,Vehicle Fire,131,131 - Passenger vehicle fire,0,18550,18550,18550,0
17-0024943,2017,Autumn,8/15/2017,413 ST BONIFACE City of Louisville KY 40202,Vehicle Fire,131,131 - Passenger vehicle fire,NULL,1000,1000,1000,0
17-0025017,2017,Autumn,8/16/2017,1327 SALE Louisville KY 40215,Structure Fire,111,111 - Building fire,10000,34000,44000,34000,-10000
17-0025021,2017,Autumn,8/16/2017,2536 W MARKET Louisville KY 40212,Structure Fire,111,111 - Building fire,NULL,500,500,68850,68350
17-0025179,2017,Autumn,8/17/2017,825 LOTUS Louisville KY 40213,Vehicle Fire,132,132 - Road freight or transport vehicle fire,0,5000,5000,10000,5000
17-0025240,2017,Autumn,8/17/2017,3001 W KENTUCKY Louisville KY 40211,Structure Fire,111,111 - Building fire,0,1000,1000,1153800,1152800
17-0025411,2017,Autumn,8/18/2017,2443 N SLEVIN Louisville KY 40212,Vehicle Fire,131,131 - Passenger vehicle fire,500,2000,2500,2000,-500
17-0025432,2017,Autumn,8/19/2017,2100 PORTLAND Louisville KY 40212,Structure Fire,112,112 - Fires in structure other than in a building,NULL,200,200,232620,232420
17-0025486,2017,Autumn,8/19/2017,CECIL Louisville KY 40211,Vehicle Fire,131,131 - Passenger vehicle fire,0,1000,1000,1000,0
17-0025530,2017,Autumn,8/19/2017,673 S 36TH Louisville KY 40211,Structure Fire,111,111 - Building fire,0,300,300,3500,3200
17-0025585,2017,Autumn,8/20/2017,1414 CATALPA Louisville KY 40211,Structure Fire,113,"113 - Cooking fire, confined to container",200,NULL,200,31500,31300
17-0025633,2017,Autumn,8/20/2017,2900 SPRINGDALE 422 Louisville KY 40206,Structure Fire,113,"113 - Cooking fire, confined to container",200,20,220,10000000,9999780
17-0025646,2017,Autumn,8/20/2017,2221 HALE Louisville KY 40210,Structure Fire,113,"113 - Cooking fire, confined to container",150,0,150,23480,23330
17-0025950,2017,Autumn,8/23/2017,124 MERIDIAN 1 Louisville KY 40207,Structure Fire,111,111 - Building fire,5000,10000,15000,687000,672000
17-0026186,2017,Autumn,8/24/2017,S 32ND Louisville KY 40211,Vehicle Fire,131,131 - Passenger vehicle fire,NULL,8400,8400,8600,200
17-0026315,2017,Autumn,8/25/2017,2331 W LEE Louisville KY 40210,Vehicle Fire,131,131 - Passenger vehicle fire,NULL,2000,2000,2000,0
17-0026315,2017,Autumn,8/25/2017,2331 W lee City of Louisville KY 40210,Structure Fire,111,111 - Building fire,NULL,500,500,18500,18000
17-0026384,2017,Autumn,8/26/2017,206 N 37TH Louisville KY 40212,Structure Fire,111,111 - Building fire,0,8000,8000,21460,13460
17-0026412,2017,Autumn,8/26/2017,2226 Wrocklage Louisville KY 40205,Vehicle Fire,131,131 - Passenger vehicle fire,100,3000,3100,3000,-100
17-0026525,2017,Autumn,8/27/2017,824 S 1ST Louisville KY 40203,Vehicle Fire,131,131 - Passenger vehicle fire,3000,3000,6000,3000,-3000
17-0026538,2017,Autumn,8/27/2017,1813 BICKNELL Louisville KY 40215,Structure Fire,113,"113 - Cooking fire, confined to container",100,0,100,38000,37900
17-0026621,2017,Autumn,8/28/2017,3741 TAYLORSVILLE Louisville KY 40220,Structure Fire,111,111 - Building fire,0,20000,20000,500000,480000
17-0026719,2017,Autumn,8/29/2017,2329 PORTLAND Louisville KY 40212,Structure Fire,111,111 - Building fire,NULL,1000,1000,81000,80000
17-0027274,2017,Autumn,9/2/2017,924 Euclid Avenue City of Louisville KY 40208,Structure Fire,111,111 - Building fire,0,50000,50000,50000,0
17-0027217,2017,Autumn,9/2/2017,4 COLONIAL OAKS 4 Louisville KY 40214,Structure Fire,111,111 - Building fire,5000,20000,25000,3000000,2975000
17-0027241,2017,Autumn,9/2/2017,745 S 36TH Louisville KY 40211,Structure Fire,113,"113 - Cooking fire, confined to container",400,0,400,39640,39240
17-0027274,2017,Autumn,9/2/2017,926 EUCLID Louisville KY 40208,Structure Fire,111,111 - Building fire,0,53240,53240,53240,0
17-0027310,2017,Autumn,9/3/2017,BRECKENRIDGE MEDE KY 40220,Vehicle Fire,131,131 - Passenger vehicle fire,NULL,3000,3000,3000,0
17-0027425,2017,Autumn,9/3/2017,S HANCOCK Louisville KY 40202,Vehicle Fire,131,131 - Passenger vehicle fire,NULL,10000,10000,10000,0
17-0027505,2017,Autumn,9/4/2017,805 MARY 4 Louisville KY 40204,Structure Fire,111,111 - Building fire,2000,30000,32000,950000,918000
17-0027529,2017,Autumn,9/4/2017,2318 W OAK Louisville KY 40210,Structure Fire,111,111 - Building fire,0,500,500,5000,4500
17-0027642,2017,Autumn,9/5/2017,3655 WHEELER Louisville KY 40215,Vehicle Fire,131,131 - Passenger vehicle fire,0,8000,8000,8000,0
17-0027644,2017,Autumn,9/5/2017,3821 ALFORD Louisville KY 40212,Structure Fire,113,"113 - Cooking fire, confined to container",400,0,400,25670,25270
17-0027697,2017,Autumn,9/6/2017,3391 YOUNG 103 Louisville KY 40211,Structure Fire,111,111 - Building fire,2000,30000,32000,900000,868000
17-0027749,2017,Autumn,9/6/2017,521 N 26TH Louisville KY 40212,Vehicle Fire,130,"130 - Mobile property (vehicle) fire, other",5,0,5,100,95
17-0027779,2017,Autumn,9/6/2017,2508 ELLIOTT Louisville KY 40211,Structure Fire,111,111 - Building fire,100,NULL,100,15900,15800
17-0027813,2017,Autumn,9/7/2017,604 S 3RD Louisville KY 40202,Structure Fire,118,"118 - Trash or rubbish fire, contained",0,500,500,1103240,1102740
17-0027880,2017,Autumn,9/7/2017,2711 NARRAGANSETT Louisville KY 40210,Structure Fire,113,"113 - Cooking fire, confined to container",1000,3000,4000,33570,29570
17-0028040,2017,Autumn,9/8/2017,1533 BEECH Louisville KY 40211,Structure Fire,113,"113 - Cooking fire, confined to container",500,1000,1500,40000,38500
17-0028061,2017,Autumn,9/9/2017,3302 RUDD Louisville KY 40212,Structure Fire,111,111 - Building fire,0,25960,25960,25960,0
17-0028068,2017,Autumn,9/9/2017,2109 EASTVIEW Louisville KY 40205,Structure Fire,111,111 - Building fire,5000,20000,25000,230000,205000
17-0028104,2017,Autumn,9/9/2017,405 HIGHWOOD Louisville KY 40206,Vehicle Fire,131,131 - Passenger vehicle fire,0,5000,5000,5000,0
17-0028152,2017,Autumn,9/9/2017,1061 RUNELL Louisville KY 40214,Structure Fire,118,"118 - Trash or rubbish fire, contained",1000,NULL,1000,125000,124000
17-0028149,2017,Autumn,9/9/2017,W JEFFERSON Louisville KY 40203,Vehicle Fire,131,131 - Passenger vehicle fire,0,4500,4500,4500,0
17-0028061,2017,Autumn,9/9/2017,3306 Rudd Louisville KY 40212,Structure Fire,111,111 - Building fire,3000,10000,13000,30290,17290
17-0028061,2017,Autumn,9/9/2017,3300 Rudd Louisville KY 40212,Structure Fire,111,111 - Building fire,NULL,5000,5000,62710,57710
17-0028279,2017,Autumn,9/10/2017,5523 HALSTEAD Louisville KY 40213,Structure Fire,111,111 - Building fire,500,2500,3000,10000,7000
17-0028291,2017,Autumn,9/10/2017,4121 BROWNS B14 Louisville KY 40220,Structure Fire,111,111 - Building fire,NULL,1000,1000,155000,154000
17-0028312,2017,Autumn,9/11/2017,323 W CARDINAL Louisville KY 40208,Structure Fire,112,112 - Fires in structure other than in a building,10000,10000,20000,10000,-10000
17-0028492,2017,Autumn,9/12/2017,736 S 1ST City of Louisville KY 40202,Outside Fire,161,161 - Outside storage fire,0,1000,1000,315000,314000
17-0028492,2017,Autumn,9/12/2017,South 1st Street City of Louisville KY 40203,FALSE,160,"160 - Special outside fire, other",NULL,1000,1000,315000,314000
17-0028578,2017,Autumn,9/13/2017,1335 PHYLLIS Louisville KY 40215,Structure Fire,111,111 - Building fire,10000,30000,40000,35300,-4700
17-0028659,2017,Autumn,9/14/2017,1619 DUMESNIL Louisville KY 40210,Structure Fire,111,111 - Building fire,8000,15000,23000,26500,3500
17-0028672,2017,Autumn,9/14/2017,1403 MCCOY Louisville KY 40215,Structure Fire,111,111 - Building fire,2000,15000,17000,47500,30500
17-0028716,2017,Autumn,9/14/2017,700 Algonquin Louisville KY 40208,Vehicle Fire,131,131 - Passenger vehicle fire,NULL,3100,3100,3100,0
17-0028781,2017,Autumn,9/15/2017,5338 S 3RD Louisville KY 40214,FALSE,151,"151 - Outside rubbish, trash or waste fire",NULL,100,100,1000,900
17-0029015,2017,Autumn,9/17/2017,3306 AUDUBON RIDGE Louisville KY 40213,Structure Fire,111,111 - Building fire,10000,40000,50000,164000,114000
17-0029123,2017,Autumn,9/18/2017,904 PLACE ROUGE Louisville KY 40203,Vehicle Fire,131,131 - Passenger vehicle fire,NULL,1500,1500,2000,500
17-0029169,2017,Autumn,9/18/2017,1416 EARL Louisville KY 40215,Outside Fire,161,161 - Outside storage fire,5000,30000,35000,30000,-5000
17-0029284,2017,Autumn,9/19/2017,1450 ARLING Louisville KY 40215,Structure Fire,111,111 - Building fire,2500,15000,17500,65000,47500
17-0029394,2017,Autumn,9/20/2017,1635 THORNBERRY Louisville KY 40215,Structure Fire,111,111 - Building fire,10000,30000,40000,115000,75000
17-0029506,2017,Autumn,9/21/2017,DIXIE Louisville KY 40210,Vehicle Fire,131,131 - Passenger vehicle fire,0,4500,4500,4500,0
17-0029570,2017,Autumn,9/22/2017,2616 CONESTOGA Louisville KY 40210,Structure Fire,111,111 - Building fire,0,500,500,25000,24500
17-0029682,2017,Autumn,9/22/2017,131 BRECKENRIDGE Louisville KY 40207,FALSE,154,154 - Dumpster or other outside trash receptacle fire,NULL,200,200,1000,800
17-0029685,2017,Autumn,9/22/2017,1146 S PRESTON Louisville KY 40203,Structure Fire,111,111 - Building fire,10000,100000,110000,124950,14950
17-0029889,2017,Autumn,9/24/2017,738 M Louisville KY 40208,Structure Fire,111,111 - Building fire,10000,20000,30000,34280,4280
17-0029888,2017,Autumn,9/24/2017,738 M Louisville KY 40208,Structure Fire,111,111 - Building fire,10000,20000,30000,34280,4280
17-0029923,2017,Autumn,9/24/2017,525 CALDWELL Louisville KY 40203,FALSE,160,"160 - Special outside fire, other",NULL,75,75,500,425
17-0029950,2017,Autumn,9/25/2017,112 E OAK Louisville KY 40203,Structure Fire,118,"118 - Trash or rubbish fire, contained",NULL,500,500,300000,299500
17-0029949,2017,Autumn,9/25/2017,BROOKLINE Louisville KY 40215,Vehicle Fire,131,131 - Passenger vehicle fire,0,8600,8600,8600,0
17-0029950,2017,Autumn,9/25/2017,112 E Oak City of Louisville KY 40215,Structure Fire,118,"118 - Trash or rubbish fire, contained",NULL,5000,5000,300000,295000
17-0030083,2017,Autumn,9/26/2017,300 N SHAWNEE Louisville KY 40212,Vehicle Fire,131,131 - Passenger vehicle fire,500,2700,3200,2700,-500
17-0030083,2017,Autumn,9/26/2017,300 N Shawnee City of Louisville KY 40211,Structure Fire,112,112 - Fires in structure other than in a building,300,10000,10300,93160,82860
17-0030408,2017,Autumn,9/28/2017,647 S 11TH City of Louisville KY 40203,FALSE,442,442 - Overheated motor,25,200,225,200,-25
17-0030765,2017,Autumn,10/1/2017,7635 SHELBYVILLE NOWD KY 40222,Structure Fire,111,111 - Building fire,10000,60000,70000,500000,430000
17-0030818,2017,Autumn,10/2/2017,112 DR W J HODGE Louisville KY 40203,Structure Fire,111,111 - Building fire,1000,5000,6000,15000,9000
17-0030868,2017,Autumn,10/2/2017,113 N 35TH Louisville KY 40212,Structure Fire,113,"113 - Cooking fire, confined to container",500,1200,1700,40100,38400
17-0031146,2017,Autumn,10/4/2017,3712 WHEELER Louisville KY 40215,Structure Fire,111,111 - Building fire,8000,20000,28000,70000,42000
17-0031064,2017,Autumn,10/4/2017,2701 BARDSTOWN Louisville KY 40205,Vehicle Fire,131,131 - Passenger vehicle fire,0,34000,34000,34000,0
17-0031241,2017,Autumn,10/5/2017,DIXIE Louisville KY 40210,Vehicle Fire,131,131 - Passenger vehicle fire,0,2000,2000,2000,0
17-0031512,2017,Autumn,10/8/2017,4248 LOUISVILLE Louisville KY 40209,Vehicle Fire,131,131 - Passenger vehicle fire,0,3000,3000,5000,2000
17-0032137,2017,Autumn,10/13/2017,1212 S 4TH 100 Louisville KY 40203,Structure Fire,111,111 - Building fire,1000,5000,6000,225000,219000
17-0032194,2017,Autumn,10/13/2017,3908 GREENWOOD Louisville KY 40211,Structure Fire,111,111 - Building fire,0,500,500,32100,31600
17-0032273,2017,Autumn,10/14/2017,626 W MAIN Louisville KY 40202,Structure Fire,113,"113 - Cooking fire, confined to container",1,1,2,1000000,999998
17-0032345,2017,Autumn,10/15/2017,1336 BLUEGRASS Louisville KY 40215,Structure Fire,111,111 - Building fire,NULL,5000,5000,50000,45000
17-0032550,2017,Autumn,10/16/2017,951 W FLORENCE Louisville KY 40215,Structure Fire,111,111 - Building fire,800,NULL,800,80000,79200
17-0032830,2017,Autumn,10/19/2017,666 CURRY Louisville KY 40211,Structure Fire,111,111 - Building fire,2000,25000,27000,25000,-2000
17-0033044,2017,Autumn,10/20/2017,W TENNY Louisville KY 40214,Vehicle Fire,131,131 - Passenger vehicle fire,0,5000,5000,15000,10000
17-0033201,2017,Autumn,10/21/2017,3727 BANK Louisville KY 40212,Structure Fire,111,111 - Building fire,5000,10000,15000,32250,17250
17-0033223,2017,Autumn,10/22/2017,LOCUST Louisville KY 40217,Outside Fire,160,"160 - Special outside fire, other",0,10,10,10,0
17-0033300,2017,Autumn,10/23/2017,LOUIS COLEMAN JR Louisville KY 40211,Vehicle Fire,131,131 - Passenger vehicle fire,100,35000,35100,35000,-100
17-0033322,2017,Autumn,10/23/2017,114 S 45TH Louisville KY 40212,Structure Fire,111,111 - Building fire,0,8000,8000,33200,25200
17-0033339,2017,Autumn,10/23/2017,118 S LONGWORTH Louisville KY 40212,Structure Fire,111,111 - Building fire,400,800,1200,40000,38800
17-0033523,2017,Autumn,10/25/2017,2622 ELLIOTT Louisville KY 40211,Structure Fire,111,111 - Building fire,0,5000,5000,23740,18740
17-0033604,2017,Autumn,10/25/2017,1815 GARDINER Louisville KY 40205,FALSE,151,"151 - Outside rubbish, trash or waste fire",NULL,200,200,200,0
17-0033668,2017,Autumn,10/26/2017,920 S 4TH Louisville KY 40203,Structure Fire,111,111 - Building fire,2000,0,2000,300000,298000
17-0033816,2017,Autumn,10/27/2017,MANSLICK Louisville KY 40215,Vehicle Fire,131,131 - Passenger vehicle fire,NULL,1000,1000,1000,0
17-0033849,2017,Autumn,10/28/2017,1457 S SHELBY 2 City of Louisville KY 40217,Structure Fire,111,111 - Building fire,150000,200000,350000,200000,-150000
17-0033940,2017,Autumn,10/28/2017,635 MARRET Louisville KY 40208,Vehicle Fire,131,131 - Passenger vehicle fire,0,500,500,500,0
17-0033849,2017,Autumn,10/28/2017,1461 Shelby City of Louisville KY 40207,Structure Fire,111,111 - Building fire,NULL,3000,3000,70000,67000
17-0033999,2017,Autumn,10/29/2017,5425 BRUCE Louisville KY 40214,Structure Fire,111,111 - Building fire,2000,29855,31855,119420,87565
17-0034019,2017,Autumn,10/29/2017,2224 MAGAZINE Louisville KY 40211,Structure Fire,111,111 - Building fire,0,10000,10000,32000,22000
17-0034060,2017,Autumn,10/30/2017,669 LOUIS COLEMAN JR Louisville KY 40211,Structure Fire,111,111 - Building fire,4000,21495,25495,42990,17495
17-0034307,2017,Autumn,10/31/2017,3719 BRIARBRIDGE 6 Louisville KY 40218,Structure Fire,111,111 - Building fire,200,NULL,200,310000,309800
17-0034199,2017,Autumn,10/31/2017,400B CAMP Louisville KY 40203,Structure Fire,111,111 - Building fire,NULL,25000,25000,50000,25000
17-0034198,2017,Autumn,10/31/2017,410 CAMP Louisville KY 40203,Structure Fire,111,111 - Building fire,NULL,30000,30000,30000,0
17-0034209,2017,Autumn,10/31/2017,522 GHEENS Louisville KY 40214,Structure Fire,111,111 - Building fire,100,NULL,100,50000,49900
17-0034270,2017,Autumn,10/31/2017,3701 TAYLOR Louisville KY 40215,Vehicle Fire,130,"130 - Mobile property (vehicle) fire, other",100,1600,1700,1600,-100
17-0034387,2017,Winter,11/1/2017,535 N 42ND Louisville KY 40212,Structure Fire,111,111 - Building fire,2000,10000,12000,23540,11540
17-0034499,2017,Winter,11/2/2017,1821 SILS Louisville KY 40205,Structure Fire,111,111 - Building fire,1000,5000,6000,273000,267000
17-0034640,2017,Winter,11/4/2017,280 W JEFFERSON Louisville KY 40202,Structure Fire,111,111 - Building fire,200,200,400,200,-200
17-0034739,2017,Winter,11/4/2017,1100 E MARKET Louisville KY 40206,Structure Fire,111,111 - Building fire,100,5000,5100,13335090,13329990
17-0034869,2017,Winter,11/5/2017,818 S 40TH Louisville KY 40211,Structure Fire,111,111 - Building fire,0,5000,5000,5000,0
17-0034928,2017,Winter,11/6/2017,2831 TYSON Louisville KY 40218,Structure Fire,111,111 - Building fire,30000,100000,130000,200000,70000
17-0035042,2017,Winter,11/7/2017,2704 CRITTENDEN Louisville KY 40209,Structure Fire,113,"113 - Cooking fire, confined to container",10000,0,10000,500000,490000
17-0035110,2017,Winter,11/7/2017,I-65 South Louisville KY 40202,Vehicle Fire,132,132 - Road freight or transport vehicle fire,80000,80000,160000,80000,-80000
17-0035117,2017,Winter,11/7/2017,1420 SALE Louisville KY 40215,Vehicle Fire,131,131 - Passenger vehicle fire,0,3000,3000,3000,0
17-0035339,2017,Winter,11/10/2017,1708 VALLEY FORGE Louisville KY 40215,Vehicle Fire,131,131 - Passenger vehicle fire,NULL,1000,1000,5000,4000
17-0035406,2017,Winter,11/10/2017,117 W BRECKINRIDGE 2 Louisville KY 40203,Structure Fire,118,"118 - Trash or rubbish fire, contained",NULL,100,100,70000,69900
17-0035494,2017,Winter,11/11/2017,I264 East Louisville KY 40211,Vehicle Fire,131,131 - Passenger vehicle fire,NULL,4500,4500,4500,0
17-0035520,2017,Winter,11/11/2017,1206 POTOMAC Louisville KY 40214,Outside Fire,161,161 - Outside storage fire,3500,3500,7000,3500,-3500
17-0035519,2017,Winter,11/11/2017,1132 PAYNE Louisville KY 40204,Outside Fire,151,"151 - Outside rubbish, trash or waste fire",0,1500,1500,6700,5200
17-0035535,2017,Winter,11/11/2017,2201 GRAND Louisville KY 40210,Structure Fire,111,111 - Building fire,2000,5000,7000,35000,28000
17-0035622,2017,Winter,11/12/2017,4400 LONSDALE Louisville KY 40215,Vehicle Fire,131,131 - Passenger vehicle fire,0,5000,5000,5000,0
17-0035724,2017,Winter,11/13/2017,2730 LINDSAY Louisville KY 40206,Structure Fire,111,111 - Building fire,500,500,1000,89110,88110
17-0035750,2017,Winter,11/13/2017,2409 W MARKET Louisville KY 40212,FALSE,151,"151 - Outside rubbish, trash or waste fire",400,NULL,400,15000,14600
17-0035746,2017,Winter,11/13/2017,1966 DEER PARK Louisville KY 40205,Structure Fire,111,111 - Building fire,10000,30000,40000,194920,154920
17-0035878,2017,Winter,11/14/2017,3670 CRAIG Louisville KY 40215,Structure Fire,118,"118 - Trash or rubbish fire, contained",NULL,1000,1000,1000,0
17-0036247,2017,Winter,11/18/2017,633 S 11TH Louisville KY 40203,Vehicle Fire,131,131 - Passenger vehicle fire,NULL,200,200,800,600
17-0036253,2017,Winter,11/18/2017,I-64 East City of Louisville KY 40202,Vehicle Fire,131,131 - Passenger vehicle fire,100,9000,9100,9000,-100
17-0036300,2017,Winter,11/18/2017,1039 LOUIS COLEMAN JR Louisville KY 40211,Vehicle Fire,131,131 - Passenger vehicle fire,100,3000,3100,3000,-100
17-0036309,2017,Winter,11/18/2017,3715 RIVER PARK Louisville KY 40211,Structure Fire,111,111 - Building fire,0,200,200,39650,39450
17-0036339,2017,Winter,11/18/2017,608 S 35TH Louisville KY 40211,Structure Fire,111,111 - Building fire,0,10400,10400,31170,20770
17-0036435,2017,Winter,11/19/2017,1127 S 6TH Louisville KY 40203,Structure Fire,111,111 - Building fire,1000,2500,3500,175000,171500
17-0036533,2017,Winter,11/20/2017,3913 RIVER PARK Louisville KY 40211,Structure Fire,111,111 - Building fire,500,1000,1500,33350,31850
17-0036531,2017,Winter,11/20/2017,2430 MCKENDREE Louisville KY 40211,Vehicle Fire,131,131 - Passenger vehicle fire,NULL,1500,1500,2000,500
17-0036537,2017,Winter,11/20/2017,608 S 37TH Louisville KY 40211,Structure Fire,111,111 - Building fire,1000,2500,3500,7500,4000
17-0036638,2017,Winter,11/21/2017,3911 GARFIELD Louisville KY 40212,Structure Fire,111,111 - Building fire,0,1000,1000,15000,14000
17-0036665,2017,Winter,11/21/2017,2522 SARATOGA Louisville KY 40205,Vehicle Fire,131,131 - Passenger vehicle fire,NULL,5000,5000,5000,0
17-0036776,2017,Winter,11/22/2017,1836 DATE Louisville KY 40210,Structure Fire,111,111 - Building fire,100,1000,1100,50000,48900
17-0036887,2017,Winter,11/24/2017,415 E MUHAMMAD ALI Louisville KY 40202,Structure Fire,118,"118 - Trash or rubbish fire, contained",30,200,230,200,-30
17-0036902,2017,Winter,11/24/2017,4420 LOUISVILLE Louisville KY 40209,Vehicle Fire,131,131 - Passenger vehicle fire,2000,NULL,2000,2000,0
17-0036972,2017,Winter,11/24/2017,4650 AIRFREIGHT Louisville KY 40209,Vehicle Fire,132,132 - Road freight or transport vehicle fire,1000,0,1000,30000,29000
17-0036980,2017,Winter,11/25/2017,428 N HITE Louisville KY 40206,FALSE,154,154 - Dumpster or other outside trash receptacle fire,NULL,500,500,795570,795070
17-0037275,2017,Winter,11/27/2017,1712 W MADISON Louisville KY 40203,Structure Fire,111,111 - Building fire,1000,20000,21000,34990,13990
17-0037371,2017,Winter,11/28/2017,2908 MONTGOMERY Louisville KY 40212,Structure Fire,111,111 - Building fire,5000,22500,27500,22500,-5000
17-0037417,2017,Winter,11/29/2017,231 CECIL Louisville KY 40212,Structure Fire,111,111 - Building fire,500,10000,10500,50000,39500
17-0037500,2017,Winter,11/29/2017,1391 DIXIE Louisville KY 40210,Structure Fire,111,111 - Building fire,5000,10000,15000,100000,85000
17-0037537,2017,Winter,11/29/2017,S 17TH Louisville KY 40203,Outside Fire,151,"151 - Outside rubbish, trash or waste fire",0,10000,10000,20000,10000
17-0037542,2017,Winter,11/30/2017,1016 SALE Louisville KY 40215,Structure Fire,111,111 - Building fire,10000,20000,30000,51000,21000
17-0037751,2017,Winter,12/1/2017,619 RAWLINGS Louisville KY 40217,Structure Fire,111,111 - Building fire,30000,50000,80000,50000,-30000
17-0037712,2017,Winter,12/1/2017,823 S 32ND Louisville KY 40211,Structure Fire,111,111 - Building fire,0,10000,10000,31770,21770
17-0037798,2017,Winter,12/2/2017,N 24TH Louisville KY 40212,Vehicle Fire,131,131 - Passenger vehicle fire,500,6000,6500,6000,-500
17-0038041,2017,Winter,12/3/2017,S 10TH Louisville KY 40203,FALSE,151,"151 - Outside rubbish, trash or waste fire",100,NULL,100,100,0
17-0038105,2017,Winter,12/4/2017,1214 Logan Louisville KY 40204,Structure Fire,111,111 - Building fire,2000,3000,5000,10000,5000
17-0038120,2017,Winter,12/4/2017,2805 NARRAGANSETT Louisville KY 40210,Structure Fire,113,"113 - Cooking fire, confined to container",500,500,1000,500,-500
17-0038125,2017,Winter,12/4/2017,701 BAXTER Louisville KY 40204,Outside Fire,151,"151 - Outside rubbish, trash or waste fire",0,300,300,5000,4700
17-0038142,2017,Winter,12/4/2017,1006 S 40TH Louisville KY 40211,Structure Fire,111,111 - Building fire,1500,800,2300,42190,39890
17-0038179,2017,Winter,12/5/2017,1001 W WHITNEY Louisville KY 40215,Vehicle Fire,131,131 - Passenger vehicle fire,0,4000,4000,4000,0
17-0038253,2017,Winter,12/5/2017,NORRIS Louisville KY 40205,FALSE,151,"151 - Outside rubbish, trash or waste fire",NULL,300,300,5000000,4999700
17-0038402,2017,Winter,12/7/2017,1172 CASTLEVALE Louisville KY 40217,Vehicle Fire,131,131 - Passenger vehicle fire,100,13000,13100,13000,-100
17-0038420,2017,Winter,12/7/2017,207 N 36TH Louisville KY 40212,Structure Fire,111,111 - Building fire,5000,15000,20000,34780,14780
17-0038638,2017,Winter,12/9/2017,415 E MUHAMMAD ALI 205 Louisville KY 40202,Structure Fire,113,"113 - Cooking fire, confined to container",2,NULL,1,1000,999
17-0038709,2017,Winter,12/9/2017,4200 TAYLOR Louisville KY 40215,Vehicle Fire,131,131 - Passenger vehicle fire,50,1200,1250,1200,-50
17-0038852,2017,Winter,12/11/2017,2703 W MAIN Louisville KY 40212,Structure Fire,111,111 - Building fire,100,4000,4100,10000,5900
17-0038962,2017,Winter,12/12/2017,1737 HALE Louisville KY 40210,Structure Fire,111,111 - Building fire,NULL,5000,5000,16400,11400
17-0038992,2017,Winter,12/12/2017,2519 DATE Louisville KY 40210,Structure Fire,118,"118 - Trash or rubbish fire, contained",500,1000,1500,20710,19210
17-0039218,2017,Winter,12/14/2017,630 BARRET Louisville KY 40204,Structure Fire,111,111 - Building fire,NULL,500,500,1940970,1940470
17-0039384,2017,Winter,12/15/2017,813 IROQUOIS Louisville KY 40214,Structure Fire,111,111 - Building fire,10000,10000,20000,100000,80000
17-0039530,2017,Winter,12/16/2017,4101 Cadillac Louisville KY 40213,Vehicle Fire,131,131 - Passenger vehicle fire,250,3500,3750,3500,-250
17-0039533,2017,Winter,12/16/2017,S 35TH Louisville KY 40211,Vehicle Fire,131,131 - Passenger vehicle fire,0,1500,1500,2000,500
17-0039645,2017,Winter,12/17/2017,146 E ASHLAND Louisville KY 40214,Structure Fire,113,"113 - Cooking fire, confined to container",3000,NULL,3000,90000,87000
17-0039640,2017,Winter,12/17/2017,4519 HAZELWOOD Louisville KY 40214,Vehicle Fire,131,131 - Passenger vehicle fire,NULL,2500,2500,2500,0
17-0039761,2017,Winter,12/18/2017,2800 BRECKENRIDGE Louisville KY 40220,Vehicle Fire,131,131 - Passenger vehicle fire,100,2000,2100,2000,-100
17-0039766,2017,Winter,12/19/2017,I264 East City of Louisville KY 40220,Vehicle Fire,131,131 - Passenger vehicle fire,100,2000,2100,2000,-100
17-0039966,2017,Winter,12/20/2017,845 RIVER CREST Louisville KY 40206,Structure Fire,111,111 - Building fire,30000,350000,380000,1000000,620000
17-0039989,2017,Winter,12/20/2017,217 W ST CATHERINE Louisville KY 40203,Structure Fire,111,111 - Building fire,NULL,500,500,250000,249500
17-0039993,2017,Winter,12/21/2017,703 BLUEGRASS Louisville KY 40215,Structure Fire,111,111 - Building fire,300,250,550,80000,79450
17-0040028,2017,Winter,12/21/2017,1925 S 7TH Louisville KY 40208,Outside Fire,151,"151 - Outside rubbish, trash or waste fire",500,500,1000,500,-500
17-0040162,2017,Winter,12/22/2017,344 N 27TH Louisville KY 40212,Vehicle Fire,131,131 - Passenger vehicle fire,300,2500,2800,2500,-300
17-0040511,2017,Winter,12/25/2017,2224 OSAGE Louisville KY 40210,Structure Fire,111,111 - Building fire,5000,10000,15000,50000,35000
17-0040643,2017,Winter,12/26/2017,4015 S 3RD 3 Louisville KY 40214,Structure Fire,113,"113 - Cooking fire, confined to container",1000,2000,3000,150000,147000
17-0040670,2017,Winter,12/27/2017,3760 PARTHENIA Louisville KY 40215,Structure Fire,111,111 - Building fire,0,5000,5000,5000,0
17-0041107,2017,Winter,12/30/2017,2306 W MADISON Louisville KY 40211,Structure Fire,111,111 - Building fire,200,3000,3200,6000,2800
17-0041122,2017,Winter,12/30/2017,316 MACON 1 Louisville KY 40207,Structure Fire,113,"113 - Cooking fire, confined to container",NULL,100,100,250000,249900
17-0041052,2017,Winter,12/30/2017,140 N 4TH City of Louisville KY 40202,Structure Fire,111,111 - Building fire,5000,100000,105000,2120290,2015290
17-0041161,2017,Winter,12/31/2017,S 4TH Louisville KY 40202,Structure Fire,112,112 - Fires in structure other than in a building,0,1000,1000,1000,0
17-0041176,2017,Winter,12/31/2017,22 City of Louisville KY 40203,Vehicle Fire,131,131 - Passenger vehicle fire,0,3500,3500,3500,0
17-0041185,2017,Winter,12/31/2017,4207 VERMONT Louisville KY 40211,Structure Fire,111,111 - Building fire,15000,5000,20000,67520,47520
18-0000002,2018,Winter,1/1/2018,217 FREEMAN Louisville KY 40214,Structure Fire,111,111 - Building fire,500,0,500,96000,95500
18-0000059,2018,Winter,1/1/2018,341 N 27TH Louisville KY 40212,Structure Fire,112,112 - Fires in structure other than in a building,NULL,5000,5000,60000,55000
18-0000113,2018,Winter,1/1/2018,1202 LILLIAN Louisville KY 40208,Structure Fire,111,111 - Building fire,5000,15000,20000,15000,-5000
18-0000131,2018,Winter,1/1/2018,314 WOODBINE Louisville KY 40208,Structure Fire,111,111 - Building fire,5000,10000,15000,10000,-5000
18-0000148,2018,Winter,1/2/2018,2636 DUNCAN Louisville KY 40212,Vehicle Fire,131,131 - Passenger vehicle fire,0,10000,10000,10000,0
18-0000328,2018,Winter,1/3/2018,140 N 4TH Louisville KY 40202,Structure Fire,111,111 - Building fire,0,1000000,1000000,25000000,24000000
18-0000454,2018,Winter,1/4/2018,2520 ELLIOTT Louisville KY 40211,Structure Fire,111,111 - Building fire,0,16120,16120,16120,0
18-0000466,2018,Winter,1/4/2018,2319 FRANKFORT Louisville KY 40206,Structure Fire,111,111 - Building fire,0,1000,1000,536750,535750
18-0000553,2018,Winter,1/4/2018,212 FREEMAN Louisville KY 40214,Structure Fire,112,112 - Fires in structure other than in a building,NULL,2500,2500,5000,2500
18-0000454,2018,Winter,1/4/2018,2518 ELLIOTT Louisville KY 40211,Structure Fire,111,111 - Building fire,0,1500,1500,17950,16450
18-0000454,2018,Winter,1/4/2018,2522 ELLIOTT Louisville KY 40211,Structure Fire,111,111 - Building fire,0,1500,1500,13800,12300
18-0000637,2018,Winter,1/5/2018,1307 HOWARD Louisville KY 40213,Structure Fire,111,111 - Building fire,0,5000,5000,150000,145000
18-0000689,2018,Winter,1/5/2018,4418 TAYLOR 17 Louisville KY 40215,Structure Fire,111,111 - Building fire,500,1000,1500,1000,-500
18-0000685,2018,Winter,1/5/2018,1708 ROSEWOOD Louisville KY 40204,Vehicle Fire,131,131 - Passenger vehicle fire,100,14000,14100,14000,-100
18-0000728,2018,Winter,1/6/2018,I-264E City of Louisville KY 40211,Vehicle Fire,131,131 - Passenger vehicle fire,400,4000,4400,4000,-400
18-0000785,2018,Winter,1/6/2018,526 DENMARK Louisville KY 40215,Structure Fire,111,111 - Building fire,1000,10000,11000,85000,74000
18-0000859,2018,Winter,1/7/2018,2216 GOLDSMITH Louisville KY 40218,Structure Fire,111,111 - Building fire,1000,NULL,1000,480000,479000
18-0000919,2018,Winter,1/7/2018,3439 NEWBURG 1 Louisville KY 40218,Structure Fire,111,111 - Building fire,500,10,510,250000,249490
18-0000931,2018,Winter,1/7/2018,312 W KENWOOD Louisville KY 40214,Structure Fire,111,111 - Building fire,NULL,1000,1000,78450,77450
18-0001021,2018,Winter,1/8/2018,513 HEYWOOD Louisville KY 40208,Structure Fire,111,111 - Building fire,15000,15000,30000,60000,30000
18-0001082,2018,Winter,1/8/2018,314 N 27TH City of Louisville KY 40212,Structure Fire,114,"114 - Chimney or flue fire, confined to chimney or flue",NULL,1000,1000,29400,28400
18-0001112,2018,Winter,1/9/2018,N 21ST Louisville KY 40203,Vehicle Fire,131,131 - Passenger vehicle fire,0,3500,3500,3500,0
18-0001352,2018,Winter,1/10/2018,2114 HALE Louisville KY 40210,Structure Fire,111,111 - Building fire,100,500,600,18000,17400
18-0001235,2018,Winter,1/10/2018,2438 ELLIOTT Louisville KY 40211,Structure Fire,111,111 - Building fire,0,15000,15000,18730,3730
18-0001436,2018,Winter,1/11/2018,1420 W JEFFERSON Louisville KY 40203,Vehicle Fire,131,131 - Passenger vehicle fire,0,6455,6455,6455,0
18-0001434,2018,Winter,1/11/2018,413 E MUHAMMAD ALI 315 City of Louisville KY 40202,Structure Fire,113,"113 - Cooking fire, confined to container",100,NULL,100,100,0
18-0001493,2018,Winter,1/12/2018,624 LINDELL Louisville KY 40211,Structure Fire,111,111 - Building fire,20000,28400,48400,37850,-10550
18-0001505,2018,Winter,1/12/2018,1800 DIXIE Louisville KY 40210,Structure Fire,113,"113 - Cooking fire, confined to container",200,NULL,200,112000,111800
18-0001595,2018,Winter,1/13/2018,4627 BELLEVUE Louisville KY 40215,Structure Fire,111,111 - Building fire,NULL,2000,2000,103200,101200
18-0001687,2018,Winter,1/14/2018,E HILL Louisville KY 40208,Vehicle Fire,131,131 - Passenger vehicle fire,0,5000,5000,5000,0
18-0001774,2018,Winter,1/14/2018,6300 WISTERIA VIEW 201 Louisville KY 40218,FALSE,743,"743 - Smoke detector activation, no fire - unintentional",NULL,800,800,88090,87290
18-0001823,2018,Winter,1/15/2018,1004 BARDSTOWN Louisville KY 40204,Vehicle Fire,131,131 - Passenger vehicle fire,NULL,300,300,2000,1700
18-0001893,2018,Winter,1/16/2018,1006 S BROOK Louisville KY 40203,Structure Fire,111,111 - Building fire,25,0,25,136930,136905
18-0001912,2018,Winter,1/16/2018,1202 BOURBON Louisville KY 40213,Structure Fire,111,111 - Building fire,1000,50000,51000,100000,49000
18-0001937,2018,Winter,1/16/2018,S 3RD Louisville KY 40214,Vehicle Fire,131,131 - Passenger vehicle fire,0,9000,9000,9000,0
18-0001934,2018,Winter,1/16/2018,1320 S PRESTON Louisville KY 40208,Structure Fire,112,112 - Fires in structure other than in a building,15000,31201,46201,39000,-7201
18-0002003,2018,Winter,1/17/2018,4617 ALLMOND Louisville KY 40209,Vehicle Fire,131,131 - Passenger vehicle fire,NULL,2000,2000,2500,500
18-0002020,2018,Winter,1/17/2018,636 EMILY Louisville KY 40206,Structure Fire,112,112 - Fires in structure other than in a building,3000,3000,6000,97180,91180
18-0002029,2018,Winter,1/17/2018,835 BRENTWOOD Louisville KY 40215,Structure Fire,111,111 - Building fire,NULL,1000,1000,36000,35000
18-0002092,2018,Winter,1/17/2018,818 S 39TH Louisville KY 40211,Structure Fire,111,111 - Building fire,5000,23515,28515,47030,18515
18-0002259,2018,Winter,1/19/2018,1716 S 35TH Louisville KY 40211,Structure Fire,111,111 - Building fire,NULL,500,500,120000,119500
18-0002302,2018,Winter,1/19/2018,2318 GARLAND Louisville KY 40211,Structure Fire,111,111 - Building fire,500,NULL,500,22500,22000
18-0002325,2018,Winter,1/20/2018,3843 W MUHAMMAD ALI Louisville KY 40212,Vehicle Fire,131,131 - Passenger vehicle fire,NULL,5000,5000,5000,0
18-0002336,2018,Winter,1/20/2018,2711 N SLEVIN Louisville KY 40212,Structure Fire,111,111 - Building fire,1000,25000,26000,50000,24000
18-0002496,2018,Winter,1/21/2018,714 LYNN Louisville KY 40217,Structure Fire,111,111 - Building fire,1000,5000,6000,137000,131000
18-0002513,2018,Winter,1/21/2018,805 S 38TH Louisville KY 40211,Structure Fire,111,111 - Building fire,10000,29000,39000,35890,-3110
18-0002557,2018,Winter,1/22/2018,400 S 8TH Louisville KY 40203,Structure Fire,111,111 - Building fire,1000,NULL,1000,5000,4000
18-0002579,2018,Winter,1/22/2018,S BROOK Louisville KY 40203,Outside Fire,151,"151 - Outside rubbish, trash or waste fire",50,0,50,1000,950
18-0002598,2018,Winter,1/22/2018,264 City of Louisville KY 40209,Vehicle Fire,131,131 - Passenger vehicle fire,200,2500,2700,2500,-200
18-0002672,2018,Winter,1/23/2018,813 S 33RD Louisville KY 40211,Structure Fire,111,111 - Building fire,5000,20670,25670,20670,-5000
18-0002812,2018,Winter,1/24/2018,1715 NELSON Shively KY 40216,Structure Fire,111,111 - Building fire,1500,8000,9500,10000,500
18-0002820,2018,Winter,1/24/2018,2354 GRINSTEAD 3 Louisville KY 40204,Structure Fire,111,111 - Building fire,5000,5000,10000,500000,490000
18-0003000,2018,Winter,1/26/2018,507 CAMDEN Louisville KY 40215,Outside Fire,162,162 - Outside equipment fire,400,400,800,400,-400
18-0003134,2018,Winter,1/27/2018,3711 W KENTUCKY Louisville KY 40211,Structure Fire,111,111 - Building fire,300,1500,1800,52270,50470
18-0003153,2018,Winter,1/27/2018,2817 GREENWOOD Louisville KY 40211,Vehicle Fire,131,131 - Passenger vehicle fire,NULL,20000,20000,20000,0
18-0003424,2018,Winter,1/30/2018,2327 WOODFORD Louisville KY 40205,Structure Fire,111,111 - Building fire,0,500,500,350000,349500
18-0003447,2018,Winter,1/30/2018,3704 KLONDIKE Louisville KY 40218,Structure Fire,111,111 - Building fire,100,0,100,175000,174900
18-0003589,2018,Winter,1/31/2018,1500 S 5TH 233 Louisville KY 40208,Structure Fire,111,111 - Building fire,15000,5000,20000,400000,380000
18-0003600,2018,Winter,1/31/2018,2208 GOLDSMITH Louisville KY 40218,Outside Fire,142,142 - Brush or brush-and-grass mixture fire,0,40,40,600000,599960
18-0003601,2018,Winter,1/31/2018,1829 DIXDALE Louisville KY 40210,Structure Fire,113,"113 - Cooking fire, confined to container",500,100,600,21000,20400
18-0003610,2018,Spring,2/1/2018,3516 BROCKTON Louisville KY 40220,Vehicle Fire,131,131 - Passenger vehicle fire,NULL,2000,2000,2000,0
18-0003609,2018,Spring,2/1/2018,4704 SOUTHERN Louisville KY 40214,Vehicle Fire,131,131 - Passenger vehicle fire,500,1500,2000,1500,-500
18-0003901,2018,Spring,2/3/2018,3732 CLIFF Louisville KY 40215,Structure Fire,111,111 - Building fire,NULL,42340,42340,42340,0
18-0003920,2018,Spring,2/3/2018,1033 HATHAWAY Louisville KY 40215,Structure Fire,111,111 - Building fire,10000,25000,35000,73000,38000
18-0003965,2018,Spring,2/3/2018,638 S 38TH 2 Louisville KY 40211,Structure Fire,111,111 - Building fire,NULL,100,100,28380,28280
18-0004045,2018,Spring,2/4/2018,1220 FISK Louisville KY 40203,Vehicle Fire,131,131 - Passenger vehicle fire,0,500,500,2200,1700
18-0004106,2018,Spring,2/5/2018,2068 S PRESTON Louisville KY 40217,Structure Fire,113,"113 - Cooking fire, confined to container",500,NULL,500,180000,179500
18-0004120,2018,Spring,2/5/2018,2306 GARLAND Louisville KY 40211,Vehicle Fire,131,131 - Passenger vehicle fire,NULL,8000,8000,8000,0
18-0004141,2018,Spring,2/5/2018,713 IOWA Louisville KY 40208,Structure Fire,111,111 - Building fire,NULL,10000,10000,59000,49000
18-0004301,2018,Spring,2/7/2018,2713 SLEVIN Louisville KY 40212,FALSE,151,"151 - Outside rubbish, trash or waste fire",NULL,100,100,21500,21400
18-0004303,2018,Spring,2/7/2018,756 S SHELBY Louisville KY 40203,Structure Fire,111,111 - Building fire,5000,11000,16000,31320,15320
18-0004545,2018,Spring,2/9/2018,3021 FURMAN Louisville KY 40220,Structure Fire,111,111 - Building fire,500,0,500,139870,139370
18-0004764,2018,Spring,2/11/2018,2427 W CHESTNUT Louisville KY 40211,Structure Fire,111,111 - Building fire,0,5000,5000,8000,3000
18-0005018,2018,Spring,2/13/2018,917 MULBERRY Louisville KY 40217,Structure Fire,118,"118 - Trash or rubbish fire, contained",500,NULL,500,500,0
18-0005310,2018,Spring,2/15/2018,N CLIFTON City of Louisville KY 40206,Vehicle Fire,131,131 - Passenger vehicle fire,NULL,100,100,1000,900
18-0005330,2018,Spring,2/15/2018,2961 BRECKENRIDGE Louisville KY 40220,Structure Fire,111,111 - Building fire,200,0,200,350000,349800
18-0005566,2018,Spring,2/17/2018,1107 ASH Louisville KY 40217,Structure Fire,111,111 - Building fire,0,2000,2000,125000,123000
18-0005643,2018,Spring,2/17/2018,4203 DANA Louisville KY 40216,Vehicle Fire,131,131 - Passenger vehicle fire,500,10000,10500,10000,-500
18-0005686,2018,Spring,2/18/2018,208 E SOUTHERN HEIGHTS Louisville KY 40209,Vehicle Fire,131,131 - Passenger vehicle fire,NULL,3000,3000,3000,0
18-0005726,2018,Spring,2/18/2018,1335 OAKWOOD Louisville KY 40215,Structure Fire,111,111 - Building fire,5000,15000,20000,25000,5000
18-0006164,2018,Spring,2/21/2018,3714 CLIFF Louisville KY 40215,Structure Fire,111,111 - Building fire,10000,60000,70000,60000,-10000
18-0006057,2018,Spring,2/21/2018,3926 S BROOK Louisville KY 40214,Structure Fire,111,111 - Building fire,5000,47000,52000,47000,-5000
18-0006164,2018,Spring,2/21/2018,3712 CLIFF Louisville KY 40215,Structure Fire,111,111 - Building fire,10000,60000,70000,60000,-10000
18-0006057,2018,Spring,2/21/2018,3928 S BROOK Louisville KY 40214,Structure Fire,111,111 - Building fire,5000,47000,52000,47000,-5000
18-0006057,2018,Spring,2/21/2018,3924 S BROOK Louisville KY 40214,Structure Fire,111,111 - Building fire,5000,47000,52000,47000,-5000
18-0006475,2018,Spring,2/24/2018,2101 PEABODY Louisville KY 40218,Structure Fire,111,111 - Building fire,2000,2000,4000,100000,96000
18-0006504,2018,Spring,2/24/2018,524 N 26TH 1 Louisville KY 40212,Structure Fire,111,111 - Building fire,500,2000,2500,27050,24550
18-0006590,2018,Spring,2/25/2018,1024 S 29TH Louisville KY 40211,Structure Fire,111,111 - Building fire,500,1500,2000,245500,243500
18-0006633,2018,Spring,2/25/2018,2911 BARDSTOWN Louisville KY 40205,Structure Fire,122,"122 - Fire in motor home, camper, recreational vehicle",1000,15000,16000,15000,-1000
18-0006763,2018,Spring,2/26/2018,228 SHAWNEE Louisville KY 40212,Vehicle Fire,131,131 - Passenger vehicle fire,0,300,300,3000,2700
18-0006779,2018,Spring,2/26/2018,827 HUMLER Louisville KY 40211,Structure Fire,111,111 - Building fire,100,NULL,100,25000,24900
18-0006826,2018,Spring,2/27/2018,5266 SOUTHERN Louisville KY 40214,Structure Fire,111,111 - Building fire,10000,20000,30000,30000,0
18-0006869,2018,Spring,2/27/2018,1323 E MAIN Louisville KY 40206,Structure Fire,111,111 - Building fire,10,40000,40010,80000,39990
18-0006876,2018,Spring,2/27/2018,524 E KENTUCKY Louisville KY 40203,Structure Fire,112,112 - Fires in structure other than in a building,1000,5000,6000,46540,40540
18-0006980,2018,Spring,2/28/2018,1103 GOSS Louisville KY 40217,Structure Fire,111,111 - Building fire,1000,20000,21000,168400,147400
18-0007029,2018,Spring,3/1/2018,403 MACLEAN Louisville KY 40209,Structure Fire,111,111 - Building fire,3000,5000,8000,20000,12000
18-0007161,2018,Spring,3/2/2018,4700 S 3RD Louisville KY 40214,Structure Fire,111,111 - Building fire,1000,NULL,1000,400000,399000
18-0007196,2018,Spring,3/2/2018,4347 S 3RD Louisville KY 40214,Vehicle Fire,131,131 - Passenger vehicle fire,0,3000,3000,3500,500
18-0007194,2018,Spring,3/2/2018,3712 NOBLITT Louisville KY 40218,Structure Fire,111,111 - Building fire,10000,70000,80000,195000,115000
18-0007264,2018,Spring,3/3/2018,2249 DATE Louisville KY 40210,Structure Fire,111,111 - Building fire,NULL,8000,8000,15000,7000
18-0007350,2018,Spring,3/4/2018,181 N BELLAIRE Louisville KY 40206,Structure Fire,112,112 - Fires in structure other than in a building,NULL,100,100,100,0
18-0007589,2018,Spring,3/6/2018,827 HUMLER Louisville KY 40211,Structure Fire,111,111 - Building fire,15000,15000,30000,36520,6520
18-0007606,2018,Spring,3/6/2018,629 S 4TH Louisville KY 40202,Structure Fire,111,111 - Building fire,1000,0,1000,813650,812650
18-0007519,2018,Spring,3/6/2018,945 S 5TH 906 Louisville KY 40203,Structure Fire,113,"113 - Cooking fire, confined to container",500,500,1000,500,-500
18-0007702,2018,Spring,3/7/2018,1108 S 26TH Louisville KY 40210,Structure Fire,111,111 - Building fire,800,2000,2800,33800,31000
18-0007833,2018,Spring,3/9/2018,3211 KEMMONS Louisville KY 40218,Vehicle Fire,131,131 - Passenger vehicle fire,500,2500,3000,2500,-500
18-0007858,2018,Spring,3/9/2018,2924 slevin Louisville KY 40212,Vehicle Fire,131,131 - Passenger vehicle fire,0,2000,2000,4000,2000
18-0007930,2018,Spring,3/10/2018,223 N 32ND Louisville KY 40212,Structure Fire,111,111 - Building fire,10000,15000,25000,39250,14250
18-0008101,2018,Spring,3/11/2018,2724 GARLAND Louisville KY 40211,Vehicle Fire,131,131 - Passenger vehicle fire,0,15000,15000,15000,0
18-0008114,2018,Spring,3/12/2018,1258 S PRESTON Louisville KY 40203,Structure Fire,112,112 - Fires in structure other than in a building,NULL,54190,54190,54190,0
18-0008141,2018,Spring,3/12/2018,1014 S 2ND Louisville KY 40203,Structure Fire,113,"113 - Cooking fire, confined to container",100,100,200,1000000,999800
18-0008219,2018,Spring,3/12/2018,I-264 E City of Louisville KY 40214,Vehicle Fire,131,131 - Passenger vehicle fire,NULL,8000,8000,8000,0
18-0008114,2018,Spring,3/12/2018,1264 S PRESTON Louisville KY 40203,Structure Fire,112,112 - Fires in structure other than in a building,NULL,2000,2000,85000,83000
18-0008114,2018,Spring,3/12/2018,1256 S PRESTON Louisville KY 40203,Structure Fire,112,112 - Fires in structure other than in a building,NULL,500,500,54190,53690
18-0008245,2018,Spring,3/13/2018,531 FRANKLIN City of Louisville KY 40202,Outside Fire,160,"160 - Special outside fire, other",500,500,1000,500,-500
18-0008315,2018,Spring,3/13/2018,CLEVELAND Louisville KY 40206,Vehicle Fire,131,131 - Passenger vehicle fire,0,4500,4500,6500,2000
18-0008412,2018,Spring,3/14/2018,1129 W ASHLAND Louisville KY 40215,Structure Fire,113,"113 - Cooking fire, confined to container",500,NULL,500,60000,59500
18-0008470,2018,Spring,3/15/2018,1818 W DATE Louisville KY 40210,Vehicle Fire,131,131 - Passenger vehicle fire,NULL,5000,5000,5000,0
18-0008478,2018,Spring,3/15/2018,STRADER Louisville KY 40215,Vehicle Fire,131,131 - Passenger vehicle fire,500,500,1000,5000,4000
18-0008492,2018,Spring,3/15/2018,2500 MONTGOMERY City of Louisville KY 40212,Structure Fire,111,111 - Building fire,2000,2000,4000,2000,-2000
18-0008592,2018,Spring,3/15/2018,1311 S 32ND Louisville KY 40211,Structure Fire,111,111 - Building fire,500,2000,2500,35120,32620
18-0008825,2018,Spring,3/17/2018,1466 S BROOK Louisville KY 40208,Structure Fire,113,"113 - Cooking fire, confined to container",100,0,100,200,100
18-0008900,2018,Spring,3/18/2018,3109 GRAND Louisville KY 40211,Structure Fire,111,111 - Building fire,10000,20000,30000,28020,-1980
18-0008906,2018,Spring,3/18/2018,2222 LAUDERDALE Louisville KY 40205,FALSE,160,"160 - Special outside fire, other",NULL,100,100,500,400
18-0009354,2018,Spring,3/21/2018,3832 KLONDIKE Louisville KY 40218,Structure Fire,111,111 - Building fire,500,NULL,500,114900,114400
18-0009563,2018,Spring,3/23/2018,4409 PRESTON Louisville KY 40213,Structure Fire,113,"113 - Cooking fire, confined to container",100,NULL,100,5000,4900
18-0009652,2018,Spring,3/24/2018,I-65 City of Louisville KY 40213,Vehicle Fire,131,131 - Passenger vehicle fire,NULL,2500,2500,2500,0
18-0009683,2018,Spring,3/24/2018,2520 7TH STREET Shively KY 40208,Structure Fire,111,111 - Building fire,15000,15000,30000,100000,70000
18-0009742,2018,Spring,3/25/2018,3901 GARLAND 1 Louisville KY 40211,Structure Fire,111,111 - Building fire,8000,50000,58000,88260,30260
18-0009971,2018,Spring,3/27/2018,E I-64 City of Louisville KY 40202,Vehicle Fire,131,131 - Passenger vehicle fire,0,5000,5000,5000,0
18-0010209,2018,Spring,3/30/2018,120 N CHARLTON Louisville KY 40206,Vehicle Fire,131,131 - Passenger vehicle fire,0,5000,5000,5000,0
18-0010306,2018,Spring,3/31/2018,421 E ST CATHERINE 102 Louisville KY 40203,Structure Fire,111,111 - Building fire,2000,2000,4000,2000,-2000
18-0010305,2018,Spring,3/31/2018,421 E ST CATHERINE Louisville KY 40203,Structure Fire,111,111 - Building fire,2000,2000,4000,300000,296000
18-0010334,2018,Spring,3/31/2018,3407 TAYLOR Louisville KY 40215,Vehicle Fire,131,131 - Passenger vehicle fire,100,2500,2600,2500,-100
18-0010378,2018,Spring,3/31/2018,I-65N City of Louisville KY 40213,Vehicle Fire,131,131 - Passenger vehicle fire,250,7000,7250,7000,-250
18-0010421,2018,Spring,4/1/2018,1742 WILSON Louisville KY 40210,Structure Fire,111,111 - Building fire,30000,30000,60000,75440,15440
18-0010441,2018,Spring,4/1/2018,1324 WALTER Louisville KY 40215,Structure Fire,111,111 - Building fire,1000,5000,6000,75000,69000
18-0010442,2018,Spring,4/1/2018,2800 RIEDLING Louisville KY 40206,Vehicle Fire,131,131 - Passenger vehicle fire,0,23000,23000,26000,3000
18-0010539,2018,Spring,4/2/2018,1600 GARLAND Louisville KY 40210,Structure Fire,111,111 - Building fire,2000,2000,4000,5000,1000
18-0010612,2018,Spring,4/3/2018,QUEEN Louisville KY 40215,Vehicle Fire,131,131 - Passenger vehicle fire,0,4000,4000,4000,0
18-0010710,2018,Spring,4/4/2018,1638 NELLIGAN Louisville KY 40203,Structure Fire,111,111 - Building fire,5000,40000,45000,40000,-5000
18-0010846,2018,Spring,4/5/2018,3203 GOLDEN TURTLE 102 Louisville KY 40218,Structure Fire,111,111 - Building fire,300,5000,5300,419100,413800
18-0010908,2018,Spring,4/5/2018,S 32ND Louisville KY 40211,Outside Fire,151,"151 - Outside rubbish, trash or waste fire",0,200,200,200,0
18-0010935,2018,Spring,4/6/2018,401 GEORGE UNSELD Louisville KY 40203,Structure Fire,111,111 - Building fire,0,1000,1000,115000,114000
18-0011001,2018,Spring,4/6/2018,3361 PEACHTREE Louisville KY 40215,Structure Fire,111,111 - Building fire,5000,30000,35000,52650,17650
18-0011013,2018,Spring,4/6/2018,S JACKSON Louisville KY 40203,FALSE,154,154 - Dumpster or other outside trash receptacle fire,NULL,500,500,500,0
18-0011001,2018,Spring,4/6/2018,3363 PEACHTREE Louisville KY 40215,Structure Fire,111,111 - Building fire,5000,30000,35000,50920,15920
18-0011148,2018,Spring,4/8/2018,845 S 6TH Louisville KY 40203,Vehicle Fire,131,131 - Passenger vehicle fire,0,400,400,400,0
18-0011185,2018,Spring,4/8/2018,2604 W MUHAMMAD ALI Louisville KY 40212,Structure Fire,118,"118 - Trash or rubbish fire, contained",NULL,300,300,16000,15700
18-0011268,2018,Spring,4/9/2018,Grinstead City of Louisville KY 40206,Vehicle Fire,131,131 - Passenger vehicle fire,150,2500,2650,3500,850
18-0011336,2018,Spring,4/9/2018,1333 BARDSTOWN Louisville KY 40204,FALSE,151,"151 - Outside rubbish, trash or waste fire",300,NULL,300,300000,299700
18-0011347,2018,Spring,4/10/2018,2517 7TH STREET Louisville KY 40208,Structure Fire,111,111 - Building fire,20000,20000,40000,350000,310000
18-0011401,2018,Spring,4/10/2018,3636 BROWNSBORO Louisville KY 40207,Vehicle Fire,131,131 - Passenger vehicle fire,NULL,20000,20000,20000,0
18-0011401,2018,Spring,4/10/2018,3636 BROWNSBORO Louisville KY 40207,Vehicle Fire,131,131 - Passenger vehicle fire,NULL,20000,20000,20000,0
18-0011401,2018,Spring,4/10/2018,3636 BROWNSBORO Louisville KY 40207,Vehicle Fire,131,131 - Passenger vehicle fire,NULL,1000,1000,20000,19000
18-0011520,2018,Spring,4/11/2018,2417 DUNCAN Louisville KY 40212,Structure Fire,111,111 - Building fire,5000,1000,6000,6000,0
18-0011546,2018,Spring,4/11/2018,1309 HIGHLAND 2 Louisville KY 40204,Structure Fire,111,111 - Building fire,2000,5000,7000,250000,243000
18-0011485,2018,Spring,4/11/2018,I 264 EB @Southern Pkwy Exit 10 City of Louisville KY 40214,Vehicle Fire,131,131 - Passenger vehicle fire,NULL,3000,3000,3000,0
18-0011788,2018,Spring,4/13/2018,2615 GREENWOOD Louisville KY 40211,Outside Fire,151,"151 - Outside rubbish, trash or waste fire",0,500,500,18350,17850
18-0011788,2018,Spring,4/13/2018,2615 GREENWOOD Louisville KY 40211,Outside Fire,151,"151 - Outside rubbish, trash or waste fire",0,500,500,18350,17850
18-0011907,2018,Spring,4/14/2018,303 AXIS 305 Louisville KY 40206,Structure Fire,111,111 - Building fire,NULL,5000,5000,60000,55000
18-0012093,2018,Spring,4/15/2018,104 N 36TH Louisville KY 40212,Structure Fire,111,111 - Building fire,10000,15000,25000,51340,26340
18-0012097,2018,Spring,4/15/2018,3612 DUMESNIL Louisville KY 40211,Vehicle Fire,131,131 - Passenger vehicle fire,NULL,3000,3000,3000,0
18-0012101,2018,Spring,4/15/2018,214 LAWSON Louisville KY 40214,Structure Fire,113,"113 - Cooking fire, confined to container",50,100,150,100000,99850
18-0012216,2018,Spring,4/17/2018,514 S 28TH Louisville KY 40211,Structure Fire,111,111 - Building fire,2500,5000,7500,10670,3170
18-0012243,2018,Spring,4/17/2018,5415 SOUTHVIEW Louisville KY 40214,Structure Fire,111,111 - Building fire,15000,15000,30000,90000,60000
18-0012336,2018,Spring,4/18/2018,934 MARSHALL Louisville KY 40204,Structure Fire,111,111 - Building fire,10000,30000,40000,80000,40000
18-0012404,2018,Spring,4/18/2018,700 GHEENS Louisville KY 40214,Structure Fire,111,111 - Building fire,2000,5000,7000,5000,-2000
18-0012560,2018,Spring,4/20/2018,2630 DIXDALE Louisville KY 40210,Vehicle Fire,131,131 - Passenger vehicle fire,NULL,7000,7000,7000,0
18-0012573,2018,Spring,4/20/2018,W RIVER City of Louisville KY 40202,Vehicle Fire,131,131 - Passenger vehicle fire,NULL,3000,3000,3000,0
18-0012829,2018,Spring,4/22/2018,1069 BARDSTOWN Louisville KY 40204,Vehicle Fire,131,131 - Passenger vehicle fire,0,500,500,5000,4500
18-0012880,2018,Spring,4/22/2018,3938 TAYLORSVILLE Louisville KY 40220,FALSE,161,161 - Outside storage fire,NULL,5000,5000,8048000,8043000
18-0012912,2018,Spring,4/22/2018,206 BULLITT Louisville KY 40222,FALSE,140,"140 - Natural vegetation fire, other",NULL,1200,1200,1900100,1898900
18-0012956,2018,Spring,4/23/2018,1123 S FLOYD City of Louisville KY 40203,Structure Fire,111,111 - Building fire,NULL,2000,2000,125000,123000
18-0012986,2018,Spring,4/23/2018,629 E OAK Louisville KY 40203,Structure Fire,113,"113 - Cooking fire, confined to container",500,500,1000,500,-500
18-0013158,2018,Spring,4/25/2018,5305 DEVERS Louisville KY 40214,Structure Fire,111,111 - Building fire,2000,25000,27000,66700,39700
18-0013178,2018,Spring,4/25/2018,310 N HITE 6 Louisville KY 40206,Structure Fire,111,111 - Building fire,200,500,700,100000,99300
18-0013199,2018,Spring,4/25/2018,128 N 37TH Louisville KY 40212,Structure Fire,111,111 - Building fire,1500,2000,3500,36000,32500
18-0013213,2018,Spring,4/25/2018,3229 GREENWOOD Louisville KY 40211,Structure Fire,111,111 - Building fire,400,1000,1400,33550,32150
18-0013227,2018,Spring,4/25/2018,403 N 42ND Louisville KY 40212,Structure Fire,111,111 - Building fire,200,NULL,200,100000,99800
18-0013492,2018,Spring,4/28/2018,4003 BELLS Louisville KY 40211,Vehicle Fire,131,131 - Passenger vehicle fire,NULL,10325,10325,10325,0
18-0013564,2018,Spring,4/28/2018,2830 VIRGINIA Louisville KY 40211,Structure Fire,111,111 - Building fire,500,500,1000,34970,33970
18-0013570,2018,Spring,4/28/2018,3608 W MARKET Louisville KY 40212,Structure Fire,113,"113 - Cooking fire, confined to container",500,NULL,500,50000,49500
18-0013618,2018,Spring,4/29/2018,6914 SOUTHSIDE Louisville KY 40214,Structure Fire,112,112 - Fires in structure other than in a building,NULL,100,100,1000,900
18-0013623,2018,Spring,4/29/2018,2925 BANK 2 Louisville KY 40212,Structure Fire,111,111 - Building fire,2500,5000,7500,160000,152500
18-0013689,2018,Spring,4/30/2018,2550 MAGAZINE Louisville KY 40211,Outside Fire,161,161 - Outside storage fire,100,500,600,500,-100
18-0013778,2018,Spring,4/30/2018,4814 BELLEVUE Louisville KY 40215,Structure Fire,111,111 - Building fire,10000,20000,30000,80000,50000
18-0013879,2018,Summer,5/1/2018,803 READING Louisville KY 40217,Structure Fire,111,111 - Building fire,NULL,2000,2000,116000,114000
18-0013962,2018,Summer,5/1/2018,520 E ORMSBY 2 Louisville KY 40203,Structure Fire,111,111 - Building fire,NULL,3000,3000,55000,52000
18-0014058,2018,Summer,5/2/2018,1013 S 3RD Louisville KY 40203,Structure Fire,111,111 - Building fire,NULL,1000,1000,1000,0
18-0014087,2018,Summer,5/2/2018,2013 LYTLE Louisville KY 40203,Vehicle Fire,131,131 - Passenger vehicle fire,0,3500,3500,3500,0
18-0014097,2018,Summer,5/3/2018,117 N 43RD Louisville KY 40212,Structure Fire,111,111 - Building fire,0,5000,5000,47400,42400
18-0014113,2018,Summer,5/3/2018,1838 STEVENS Louisville KY 40205,Structure Fire,111,111 - Building fire,25000,40000,65000,150000,85000
18-0014097,2018,Summer,5/3/2018,117 N 43RD Louisville KY 40212,Vehicle Fire,131,131 - Passenger vehicle fire,0,5000,5000,20000,15000
18-0014208,2018,Summer,5/3/2018,1524 GARLAND Louisville KY 40210,Structure Fire,111,111 - Building fire,2000,5000,7000,16740,9740
18-0014211,2018,Summer,5/3/2018,1740 W GAULBERT Louisville KY 40210,Structure Fire,111,111 - Building fire,0,100,100,100000,99900
18-0014113,2018,Summer,5/3/2018,1840 STEVENS Louisville KY 40205,Structure Fire,111,111 - Building fire,20000,40000,60000,150000,90000
18-0014113,2018,Summer,5/3/2018,1836 STEVENS Louisville KY 40205,Structure Fire,111,111 - Building fire,0,2000,2000,150000,148000
18-0014097,2018,Summer,5/3/2018,117 N 43RD Louisville KY 40212,Vehicle Fire,131,131 - Passenger vehicle fire,0,5000,5000,10000,5000
18-0014269,2018,Summer,5/4/2018,408 KENSINGTON 5 Louisville KY 40208,Vehicle Fire,131,131 - Passenger vehicle fire,NULL,5000,5000,5000,0
18-0014413,2018,Summer,5/5/2018,3715 RIVER PARK Louisville KY 40211,Structure Fire,111,111 - Building fire,0,3000,3000,39560,36560
18-0014426,2018,Summer,5/5/2018,661 HECKS Louisville KY 40211,Structure Fire,111,111 - Building fire,100,1000,1100,19070,17970
18-0014657,2018,Summer,5/7/2018,74 WINIFREDE Louisville KY 40206,Structure Fire,111,111 - Building fire,5000,10000,15000,117880,102880
18-0014688,2018,Summer,5/7/2018,4400B CHURCHMAN Louisville KY 40215,Structure Fire,111,111 - Building fire,1000,10000,11000,200000,189000
18-0014823,2018,Summer,5/8/2018,1265 FARMDALE Louisville KY 40213,Vehicle Fire,131,131 - Passenger vehicle fire,NULL,8000,8000,8000,0
18-0014830,2018,Summer,5/8/2018,1203 ROADWAY Louisville KY 40208,Vehicle Fire,130,"130 - Mobile property (vehicle) fire, other",NULL,4000,4000,5000,1000
18-0014981,2018,Summer,5/9/2018,2130 W BROADWAY Louisville KY 40211,Vehicle Fire,131,131 - Passenger vehicle fire,0,4000,4000,4000,0
18-0015170,2018,Summer,5/11/2018,1309 S 22ND Louisville KY 40210,Structure Fire,111,111 - Building fire,NULL,8000,8000,19910,11910
18-0015195,2018,Summer,5/11/2018,I-264E City of Louisville KY 40218,Vehicle Fire,131,131 - Passenger vehicle fire,0,500,500,2000,1500
18-0015251,2018,Summer,5/12/2018,1202 LILLIAN Louisville KY 40208,Structure Fire,111,111 - Building fire,NULL,8000,8000,8000,0
18-0015255,2018,Summer,5/12/2018,1116 LILLIAN Louisville KY 40208,Vehicle Fire,131,131 - Passenger vehicle fire,0,500,500,500,0
18-0015371,2018,Summer,5/13/2018,441 N 41ST Louisville KY 40212,Structure Fire,111,111 - Building fire,0,500,500,50000,49500
18-0015522,2018,Summer,5/14/2018,2635 ST XAVIER Louisville KY 40212,Vehicle Fire,131,131 - Passenger vehicle fire,250,5000,5250,5000,-250
18-0015611,2018,Summer,5/14/2018,3057 WEDGEWOOD Louisville KY 40220,Vehicle Fire,131,131 - Passenger vehicle fire,0,300,300,6000,5700
18-0015663,2018,Summer,5/15/2018,905 ALGONQUIN Louisville KY 40208,Structure Fire,111,111 - Building fire,2000,10000,12000,90000,78000
18-0015840,2018,Summer,5/16/2018,N SPRING Louisville KY 40206,Vehicle Fire,131,131 - Passenger vehicle fire,NULL,8000,8000,8000,0
18-0015883,2018,Summer,5/16/2018,I64E City of Louisville KY 40202,Vehicle Fire,132,132 - Road freight or transport vehicle fire,0,500,500,500,0
18-0015924,2018,Summer,5/17/2018,5118 LAUGHLIN Louisville KY 40214,Structure Fire,111,111 - Building fire,500,5000,5500,5000,-500
18-0016004,2018,Summer,5/17/2018,27 NICHOLS Louisville KY 40215,Structure Fire,111,111 - Building fire,1000,5000,6000,16600,10600
18-0016175,2018,Summer,5/19/2018,1053 GOSS Louisville KY 40217,Structure Fire,113,"113 - Cooking fire, confined to container",1000,200,1200,265000,263800
18-0016225,2018,Summer,5/19/2018,1704 LAFAYETTE 3 Louisville KY 40215,Structure Fire,113,"113 - Cooking fire, confined to container",500,NULL,500,50000,49500
18-0016228,2018,Summer,5/20/2018,3409 HEATHERFIELD Shively KY 40216,Structure Fire,111,111 - Building fire,15000,20000,35000,100220,65220
18-0016252,2018,Summer,5/20/2018,1531 CENTRAL Louisville KY 40208,Vehicle Fire,131,131 - Passenger vehicle fire,NULL,5000,5000,5000,0
18-0016257,2018,Summer,5/20/2018,1503 DELMAR Louisville KY 40216,Structure Fire,111,111 - Building fire,NULL,10000,10000,132080,122080
18-0016433,2018,Summer,5/21/2018,1196 INNIS 1 Louisville KY 40204,Structure Fire,111,111 - Building fire,0,5000,5000,350000,345000
18-0016503,2018,Summer,5/22/2018,905 W WHITNEY Louisville KY 40215,Structure Fire,111,111 - Building fire,500,10000,10500,10000,-500
18-0016931,2018,Summer,5/25/2018,I264W Louisville KY 40211,Vehicle Fire,131,131 - Passenger vehicle fire,300,2000,2300,2000,-300
18-0016945,2018,Summer,5/25/2018,1255 W ASHLAND Louisville KY 40215,Vehicle Fire,131,131 - Passenger vehicle fire,0,1000,1000,1000,0
18-0016994,2018,Summer,5/26/2018,1316 CYPRESS Louisville KY 40211,Structure Fire,111,111 - Building fire,20000,15000,35000,20300,-14700
18-0017252,2018,Summer,5/28/2018,S 8TH Louisville KY 40203,Vehicle Fire,131,131 - Passenger vehicle fire,NULL,8000,8000,8000,0
18-0017339,2018,Summer,5/29/2018,733 E JEFFERSON Louisville KY 40202,Structure Fire,111,111 - Building fire,1500,NULL,1500,42000,40500
18-0017354,2018,Summer,5/29/2018,N 34TH Louisville KY 40212,Vehicle Fire,131,131 - Passenger vehicle fire,1500,4000,5500,15000,9500
18-0017397,2018,Summer,5/29/2018,E LIBERTY Louisville KY 40202,Vehicle Fire,131,131 - Passenger vehicle fire,NULL,500,500,1500,1000
18-0017480,2018,Summer,5/30/2018,3134 BOHANNON Louisville KY 40215,Structure Fire,111,111 - Building fire,1000,5000,6000,50000,44000
18-0017926,2018,Summer,6/1/2018,taylor blvd. City of Louisville KY 40215,Vehicle Fire,131,131 - Passenger vehicle fire,NULL,5000,5000,5000,0
18-0017871,2018,Summer,6/1/2018,104 N 46TH Louisville KY 40212,Structure Fire,111,111 - Building fire,600,0,600,40130,39530
18-0017968,2018,Summer,6/2/2018,303 CECIL Louisville KY 40212,Vehicle Fire,131,131 - Passenger vehicle fire,NULL,2000,2000,10000,8000
18-0017978,2018,Summer,6/2/2018,319 ARBOR Louisville KY 40214,Vehicle Fire,131,131 - Passenger vehicle fire,500,10000,10500,10000,-500
18-0018029,2018,Summer,6/2/2018,I 64 East City of Louisville KY 40212,Vehicle Fire,131,131 - Passenger vehicle fire,0,1000,1000,1500,500
18-0018069,2018,Summer,6/2/2018,1803 COMMERCE Louisville KY 40208,Structure Fire,112,112 - Fires in structure other than in a building,0,3000,3000,3000,0
18-0018157,2018,Summer,6/3/2018,2804 SHANNON Louisville KY 40220,Structure Fire,113,"113 - Cooking fire, confined to container",1000,1000,2000,145000,143000
18-0018429,2018,Summer,6/5/2018,3025 POPLAR LEVEL Louisville KY 40213,Outside Fire,142,142 - Brush or brush-and-grass mixture fire,0,50,50,50,0
18-0018441,2018,Summer,6/5/2018,DR W J HODGE Louisville KY 40210,Vehicle Fire,131,131 - Passenger vehicle fire,NULL,8500,8500,8500,0
18-0018520,2018,Summer,6/6/2018,1000 W BROADWAY Louisville KY 40203,Vehicle Fire,131,131 - Passenger vehicle fire,0,10000,10000,10000,0
18-0018527,2018,Summer,6/6/2018,Mellwood City of Louisville KY 40206,Vehicle Fire,131,131 - Passenger vehicle fire,NULL,2000,2000,2000,0
18-0018633,2018,Summer,6/7/2018,4623 PRESTON Louisville KY 40213,Outside Fire,142,142 - Brush or brush-and-grass mixture fire,100,0,100,3201390,3201290
18-0018701,2018,Summer,6/7/2018,1326 SHINGO Louisville KY 40215,Structure Fire,111,111 - Building fire,5000,5000,10000,5000,-5000
18-0018764,2018,Summer,6/8/2018,I-65 S City of Louisville KY 40213,Vehicle Fire,131,131 - Passenger vehicle fire,1000,8000,9000,8000,-1000
18-0018805,2018,Summer,6/8/2018,I264 City of Louisville KY 40220,Vehicle Fire,131,131 - Passenger vehicle fire,NULL,5000,5000,5000,0
18-0018829,2018,Summer,6/8/2018,I264 East City of Louisville KY 40211,Vehicle Fire,131,131 - Passenger vehicle fire,250,3000,3250,3000,-250
18-0018863,2018,Summer,6/8/2018,3404 RIVER PARK Louisville KY 40211,Structure Fire,113,"113 - Cooking fire, confined to container",50,NULL,50,50,0
18-0018873,2018,Summer,6/8/2018,3831 W MUHAMMAD ALI Louisville KY 40212,Vehicle Fire,131,131 - Passenger vehicle fire,0,3000,3000,4000,1000
18-0018895,2018,Summer,6/9/2018,1218 BRASHEAR Louisville KY 40210,Vehicle Fire,131,131 - Passenger vehicle fire,NULL,2500,2500,4000,1500
18-0018942,2018,Summer,6/9/2018,4216 GRAND Louisville KY 40211,Structure Fire,111,111 - Building fire,10000,40000,50000,49000,-1000
18-0018948,2018,Summer,6/9/2018,1368 DIXIE Louisville KY 40210,Structure Fire,113,"113 - Cooking fire, confined to container",100,0,100,19800,19700
18-0018955,2018,Summer,6/9/2018,1101 W OAK Louisville KY 40210,Vehicle Fire,132,132 - Road freight or transport vehicle fire,NULL,15000,15000,20000,5000
18-0019476,2018,Summer,6/13/2018,1003 CARLISLE Louisville KY 40215,Structure Fire,111,111 - Building fire,4500,4500,9000,60000,51000
18-0019482,2018,Summer,6/13/2018,347 N 23RD Louisville KY 40212,Structure Fire,111,111 - Building fire,500,2500,3000,5000,2000
18-0019500,2018,Summer,6/14/2018,2016 WILSON Louisville KY 40210,Structure Fire,111,111 - Building fire,NULL,26270,26270,26270,0
18-0019616,2018,Summer,6/15/2018,410 S 5TH Louisville KY 40202,Vehicle Fire,131,131 - Passenger vehicle fire,NULL,7000,7000,22000,15000
18-0019623,2018,Summer,6/15/2018,2015 BANK Louisville KY 40203,Structure Fire,111,111 - Building fire,0,1000,1000,62130,61130
18-0019623,2018,Summer,6/15/2018,2017 BANK Louisville KY 40203,Structure Fire,111,111 - Building fire,NULL,61590,61590,61590,0
18-0019664,2018,Summer,6/15/2018,1009 ESQUIRE Louisville KY 40203,Structure Fire,111,111 - Building fire,5000,10000,15000,100000,85000
18-0019710,2018,Summer,6/15/2018,2302 MEADOW Louisville KY 40205,Structure Fire,111,111 - Building fire,1000,0,1000,350000,349000
18-0019623,2018,Summer,6/15/2018,2023 BANK Louisville KY 40203,Structure Fire,111,111 - Building fire,NULL,1000,1000,47980,46980
18-0019926,2018,Summer,6/17/2018,232 N 20TH Louisville KY 40203,Structure Fire,111,111 - Building fire,NULL,2000,2000,17520,15520
18-0019882,2018,Summer,6/17/2018,511 N 26TH Louisville KY 40212,Structure Fire,111,111 - Building fire,NULL,1000,1000,5000,4000
18-0019926,2018,Summer,6/17/2018,232 N 20TH Louisville KY 40203,Structure Fire,111,111 - Building fire,NULL,51000,51000,51000,0
18-0020138,2018,Summer,6/19/2018,701 HOMESTEAD Louisville KY 40207,Structure Fire,111,111 - Building fire,30,385,415,385,-30
18-0020157,2018,Summer,6/19/2018,2740 FRANKFORT Louisville KY 40206,Vehicle Fire,132,132 - Road freight or transport vehicle fire,500,NULL,500,5000,4500
18-0020282,2018,Summer,6/20/2018,535 S 22ND Louisville KY 40211,Structure Fire,111,111 - Building fire,0,10000,10000,10000,0
18-0020352,2018,Summer,6/20/2018,304 N 41ST Louisville KY 40212,Structure Fire,111,111 - Building fire,4000,12000,16000,85000,69000
18-0020362,2018,Summer,6/20/2018,2148 W LEE Louisville KY 40210,Structure Fire,111,111 - Building fire,5000,5000,10000,45000,35000
18-0020422,2018,Summer,6/21/2018,2972 WILSON Louisville KY 40211,Vehicle Fire,131,131 - Passenger vehicle fire,NULL,800,800,1200,400
18-0020787,2018,Summer,6/24/2018,MOORE Louisville KY 40210,Vehicle Fire,131,131 - Passenger vehicle fire,NULL,5000,5000,5000,0
18-0020883,2018,Summer,6/25/2018,3115 COMMANDER Louisville KY 40220,Vehicle Fire,131,131 - Passenger vehicle fire,NULL,15000,15000,15000,0
18-0021310,2018,Summer,6/28/2018,W WELLINGTON Louisville KY 40214,Vehicle Fire,131,131 - Passenger vehicle fire,0,200,200,200,0
18-0021397,2018,Summer,6/28/2018,2nd street City of Louisville KY 40202,Vehicle Fire,131,131 - Passenger vehicle fire,0,2000,2000,2000,0
18-0021517,2018,Summer,6/29/2018,I264 City of Louisville KY 40220,Vehicle Fire,131,131 - Passenger vehicle fire,NULL,3500,3500,3500,0
18-0021520,2018,Summer,6/29/2018,2216 DUNDEE Louisville KY 40205,Structure Fire,111,111 - Building fire,40000,200000,240000,1500000,1260000
18-0021574,2018,Summer,6/30/2018,3203 NORTHWESTERN Louisville KY 40212,Vehicle Fire,131,131 - Passenger vehicle fire,500,3500,4000,3500,-500
18-0021821,2018,Summer,7/1/2018,1013 S 32ND Louisville KY 40211,Structure Fire,111,111 - Building fire,500,500,1000,500,-500
18-0021981,2018,Summer,7/3/2018,529 N 34TH Louisville KY 40212,Vehicle Fire,131,131 - Passenger vehicle fire,NULL,500,500,2500,2000
18-0022076,2018,Summer,7/3/2018,951 GOSS Louisville KY 40217,Structure Fire,113,"113 - Cooking fire, confined to container",600,0,600,600,0
18-0022095,2018,Summer,7/4/2018,613 S 38TH 2 Louisville KY 40211,Structure Fire,111,111 - Building fire,2000,15000,17000,74000,57000
18-0022110,2018,Summer,7/4/2018,2807 7TH STREET 1 Louisville KY 40215,Structure Fire,113,"113 - Cooking fire, confined to container",500,NULL,500,81940,81440
18-0022178,2018,Summer,7/4/2018,25th City of Louisville KY 40212,Structure Fire,118,"118 - Trash or rubbish fire, contained",NULL,50,50,60,10
18-0022355,2018,Summer,7/5/2018,4207 SUNSET Louisville KY 40211,Structure Fire,111,111 - Building fire,NULL,10000,10000,56640,46640
18-0022446,2018,Summer,7/6/2018,I65 North near Fern Valley Road exit City of Louisville KY 40213,Vehicle Fire,131,131 - Passenger vehicle fire,200,2000,2200,2000,-200
18-0022463,2018,Summer,7/6/2018,207 W MARKET Louisville KY 40202,FALSE,162,162 - Outside equipment fire,NULL,18000,18000,20000,2000
18-0022455,2018,Summer,7/6/2018,1840 W LEE Louisville KY 40210,Structure Fire,111,111 - Building fire,5000,12000,17000,32000,15000
18-0022485,2018,Summer,7/6/2018,3348 TAYLOR Louisville KY 40215,Vehicle Fire,131,131 - Passenger vehicle fire,1000,1000,2000,3000,1000
18-0022502,2018,Summer,7/6/2018,744 S 44TH Louisville KY 40211,Structure Fire,111,111 - Building fire,1200,500,1700,66940,65240
18-0022568,2018,Summer,7/7/2018,71 COLLEGE 68 Louisville KY 40203,Structure Fire,111,111 - Building fire,0,6000,6000,6000,0
18-0022590,2018,Summer,7/7/2018,S 8TH Louisville KY 40203,Vehicle Fire,131,131 - Passenger vehicle fire,5000,5000,10000,5000,-5000
18-0022627,2018,Summer,7/7/2018,3708 TAYLORSVILLE C10 Louisville KY 40220,Structure Fire,111,111 - Building fire,7000,40000,47000,600000,553000
18-0022761,2018,Summer,7/9/2018,523 E OAK Louisville KY 40203,Structure Fire,111,111 - Building fire,0,500,500,175000,174500
18-0022859,2018,Summer,7/9/2018,3023 S 6TH Louisville KY 40208,Structure Fire,111,111 - Building fire,NULL,5000,5000,40000,35000
18-0022876,2018,Summer,7/9/2018,978 S 3RD Louisville KY 40203,Vehicle Fire,131,131 - Passenger vehicle fire,NULL,2500,2500,9000,6500
18-0023180,2018,Summer,7/12/2018,400 E BROADWAY Louisville KY 40202,Structure Fire,113,"113 - Cooking fire, confined to container",0,5000,5000,200000,195000
18-0023237,2018,Summer,7/12/2018,1533 WILSON Louisville KY 40210,Structure Fire,111,111 - Building fire,7500,20000,27500,50000,22500
18-0023261,2018,Summer,7/12/2018,3101 DR WILLIAM G WEATHERS Louisville KY 40211,Vehicle Fire,131,131 - Passenger vehicle fire,NULL,10000,10000,10000,0
18-0023313,2018,Summer,7/13/2018,603 GHEENS Louisville KY 40214,FALSE,322,322 - Motor vehicle accident with injuries,NULL,25000,25000,85000,60000
18-0023527,2018,Summer,7/14/2018,S 2ND Louisville KY 40214,Vehicle Fire,131,131 - Passenger vehicle fire,500,3500,4000,3500,-500
18-0023555,2018,Summer,7/14/2018,S 17TH Louisville KY 40203,Vehicle Fire,131,131 - Passenger vehicle fire,0,4000,4000,6000,2000
18-0023567,2018,Summer,7/14/2018,1225 WELLER City of Louisville KY 40208,Structure Fire,111,111 - Building fire,5000,30000,35000,80000,45000
18-0023784,2018,Summer,7/17/2018,120 N 10TH Louisville KY 40202,Vehicle Fire,131,131 - Passenger vehicle fire,0,12000,12000,12000,0
18-0024029,2018,Summer,7/19/2018,N 29TH Louisville KY 40212,Structure Fire,111,111 - Building fire,2500,2500,5000,22430,17430
18-0024404,2018,Summer,7/21/2018,745 S 44TH Louisville KY 40211,Structure Fire,111,111 - Building fire,7000,10000,17000,78460,61460
18-0024406,2018,Summer,7/21/2018,1971 QUARRY Louisville KY 40206,Structure Fire,111,111 - Building fire,2500,5000,7500,102970,95470
18-0024415,2018,Summer,7/21/2018,2910 WOODLAND Louisville KY 40211,Structure Fire,111,111 - Building fire,0,79000,79000,79000,0
18-0024442,2018,Summer,7/21/2018,203 BRECKINRIDGE Louisville KY 40220,Vehicle Fire,131,131 - Passenger vehicle fire,0,1000,1000,2000,1000
18-0024591,2018,Summer,7/23/2018,264 E Louisville KY 40213,Vehicle Fire,131,131 - Passenger vehicle fire,0,1000,1000,3500,2500
18-0024628,2018,Summer,7/23/2018,2806 FINN Louisville KY 40208,Structure Fire,118,"118 - Trash or rubbish fire, contained",NULL,500,500,38000,37500
18-0024637,2018,Summer,7/23/2018,4202 SOUTHERN Louisville KY 40214,Structure Fire,111,111 - Building fire,20000,30000,50000,180000,130000
18-0024692,2018,Summer,7/24/2018,826 E MADISON Louisville KY 40204,Structure Fire,111,111 - Building fire,0,5000,5000,100000,95000
18-0024815,2018,Summer,7/24/2018,812 E ST CATHERINE Louisville KY 40203,Structure Fire,111,111 - Building fire,NULL,50000,50000,90000,40000
18-0024857,2018,Summer,7/25/2018,N BROOK Louisville KY 40202,Vehicle Fire,130,"130 - Mobile property (vehicle) fire, other",2000,6000,8000,10000,2000
18-0024980,2018,Summer,7/26/2018,963 S PRESTON Louisville KY 40203,Structure Fire,111,111 - Building fire,0,30000,30000,47600,17600
18-0025307,2018,Summer,7/28/2018,3413 DEIBEL Louisville KY 40220,Structure Fire,111,111 - Building fire,1000,10000,11000,160000,149000
18-0025322,2018,Summer,7/28/2018,3736 LENTZ Louisville KY 40215,Structure Fire,111,111 - Building fire,1000,1000,2000,66640,64640
18-0025467,2018,Summer,7/29/2018,2331 W CHESTNUT Louisville KY 40211,Outside Fire,151,"151 - Outside rubbish, trash or waste fire",0,1000,1000,48660,47660
18-0025535,2018,Summer,7/30/2018,3701 7TH STREET Louisville KY 40216,Vehicle Fire,131,131 - Passenger vehicle fire,NULL,3000,3000,3000,0
18-0025862,2018,Autumn,8/1/2018,1018 ELLISON Louisville KY 40204,Structure Fire,111,111 - Building fire,0,15000,15000,60000,45000
18-0025995,2018,Autumn,8/3/2018,1400 W MADISON Louisville KY 40203,Vehicle Fire,131,131 - Passenger vehicle fire,NULL,10000,10000,15000,5000
18-0026185,2018,Autumn,8/4/2018,119 W GARRETT Louisville KY 40214,Structure Fire,111,111 - Building fire,NULL,4000,4000,75000,71000
18-0026323,2018,Autumn,8/5/2018,3412 TAYLORSVILLE 3 Louisville KY 40205,Structure Fire,113,"113 - Cooking fire, confined to container",40,0,40,250000,249960
18-0026512,2018,Autumn,8/6/2018,4526 JANICE Louisville KY 40216,Structure Fire,111,111 - Building fire,15000,25000,40000,76260,36260
18-0026793,2018,Autumn,8/9/2018,3241 YOUNG 7 Louisville KY 40211,Structure Fire,111,111 - Building fire,NULL,1500,1500,50000,48500
18-0026810,2018,Autumn,8/9/2018,2242 LANDAN Louisville KY 40218,Structure Fire,111,111 - Building fire,1200,200,1400,187800,186400
18-0026957,2018,Autumn,8/10/2018,NEW CUT Louisville KY 40214,Structure Fire,111,111 - Building fire,0,2000,2000,250000,248000
18-0027036,2018,Autumn,8/10/2018,1506 BERRY Louisville KY 40215,Vehicle Fire,131,131 - Passenger vehicle fire,0,500,500,1000,500
18-0027187,2018,Autumn,8/12/2018,1917 DUNCAN Louisville KY 40212,Structure Fire,111,111 - Building fire,5000,10000,15000,19850,4850
18-0027189,2018,Autumn,8/12/2018,1917 DUNCAN Louisville KY 40203,Structure Fire,111,111 - Building fire,5000,10000,15000,19850,4850
18-0027216,2018,Autumn,8/12/2018,2606 PINDELL Louisville KY 40217,Structure Fire,111,111 - Building fire,15000,25000,40000,106000,66000
18-0027381,2018,Autumn,8/13/2018,STEEDLY Louisville KY 40214,Vehicle Fire,132,132 - Road freight or transport vehicle fire,500,25000,25500,25000,-500
18-0027314,2018,Autumn,8/13/2018,222 S 1ST Louisville KY 40202,FALSE,164,164 - Outside mailbox fire,NULL,1000,1000,1000,0
18-0027408,2018,Autumn,8/13/2018,1414 CATALPA Louisville KY 40211,Structure Fire,111,111 - Building fire,0,500,500,1000,500
18-0027410,2018,Autumn,8/13/2018,I-264 City of Louisville KY 40209,Vehicle Fire,131,131 - Passenger vehicle fire,NULL,1000,1000,1000,0
18-0027366,2018,Autumn,8/13/2018,1008 Winkler Louisville KY 40208,Structure Fire,111,111 - Building fire,NULL,5000,5000,40680,35680
18-0027575,2018,Autumn,8/15/2018,2328 ST LOUIS Louisville KY 40210,Structure Fire,111,111 - Building fire,0,21930,21930,21930,0
18-0027667,2018,Autumn,8/15/2018,264 City of Shively KY 40216,Vehicle Fire,131,131 - Passenger vehicle fire,1000,10000,11000,10000,-1000
18-0027784,2018,Autumn,8/16/2018,1710 LAFAYETTE 2 Louisville KY 40215,Structure Fire,111,111 - Building fire,5000,12000,17000,121000,104000
18-0027847,2018,Autumn,8/17/2018,2612 MONTGOMERY Louisville KY 40212,Vehicle Fire,131,131 - Passenger vehicle fire,100,2800,2900,3300,400
18-0027954,2018,Autumn,8/17/2018,4820 PRESTON Louisville KY 40213,Vehicle Fire,131,131 - Passenger vehicle fire,NULL,3500,3500,5000,1500
18-0027962,2018,Autumn,8/17/2018,408 S 12TH Louisville KY 40203,Structure Fire,113,"113 - Cooking fire, confined to container",100,0,100,10000,9900
18-0027988,2018,Autumn,8/18/2018,1817 W MARKET Louisville KY 40203,Structure Fire,111,111 - Building fire,0,13000,13000,13000,0
18-0028093,2018,Autumn,8/18/2018,540 BRENTWOOD Louisville KY 40215,Structure Fire,113,"113 - Cooking fire, confined to container",500,0,500,85000,84500
18-0028100,2018,Autumn,8/18/2018,521 LAMPTON Louisville KY 40203,Structure Fire,111,111 - Building fire,1000,5000,6000,2553060,2547060
18-0028107,2018,Autumn,8/18/2018,108 S 35TH Louisville KY 40212,Structure Fire,111,111 - Building fire,10000,10000,20000,29220,9220
18-0028223,2018,Autumn,8/20/2018,533 E ST CATHERINE Louisville KY 40203,Structure Fire,111,111 - Building fire,0,1000,1000,70000,69000
18-0028325,2018,Autumn,8/20/2018,723 CAMDEN Louisville KY 40215,Vehicle Fire,131,131 - Passenger vehicle fire,NULL,500,500,75000,74500
18-0028346,2018,Autumn,8/21/2018,325 N SHAWNEE Louisville KY 40212,Structure Fire,111,111 - Building fire,2000,1000,3000,81850,78850
18-0028696,2018,Autumn,8/23/2018,2909 FERN VALLEY Louisville KY 40213,Structure Fire,116,"116 - Fuel burner/boiler malfunction, fire confined",3000,NULL,3000,100000,97000
18-0028723,2018,Autumn,8/24/2018,1106 LEHIGH Louisville KY 40215,Structure Fire,111,111 - Building fire,2000,10000,12000,90000,78000
18-0028735,2018,Autumn,8/24/2018,2708 RIEDLING Louisville KY 40206,Vehicle Fire,131,131 - Passenger vehicle fire,0,2000,2000,5000,3000
18-0028817,2018,Autumn,8/24/2018,350 W CHESTNUT Louisville KY 40202,Structure Fire,111,111 - Building fire,2500,10000,12500,1000000,987500
18-0028930,2018,Autumn,8/25/2018,2614 HALE Louisville KY 40211,Structure Fire,111,111 - Building fire,500,4000,4500,4000,-500
18-0028963,2018,Autumn,8/26/2018,I-64 West City of Louisville KY 40212,Vehicle Fire,131,131 - Passenger vehicle fire,NULL,3500,3500,4000,500
18-0028973,2018,Autumn,8/26/2018,4418 TAYLOR 18 Louisville KY 40215,Structure Fire,111,111 - Building fire,5000,25000,30000,25000,-5000
18-0029103,2018,Autumn,8/27/2018,2424 ELLIOTT Louisville KY 40211,Structure Fire,111,111 - Building fire,0,4000,4000,13900,9900
18-0029427,2018,Autumn,8/29/2018,1962 GOLDSMITH 5 Louisville KY 40218,Structure Fire,113,"113 - Cooking fire, confined to container",600,NULL,600,24203,23603
18-0029504,2018,Autumn,8/30/2018,2308 GREENWOOD Louisville KY 40210,Structure Fire,111,111 - Building fire,5000,20000,25000,24750,-250
18-0029615,2018,Autumn,8/31/2018,I-264 Eastbound Louisville KY 40209,Vehicle Fire,131,131 - Passenger vehicle fire,0,5000,5000,5000,0
18-0029671,2018,Autumn,8/31/2018,1041 ZORN Louisville KY 40207,Vehicle Fire,130,"130 - Mobile property (vehicle) fire, other",2000,3000,5000,8000,3000
18-0029785,2018,Autumn,9/1/2018,1279 BARDSTOWN Louisville KY 40204,Structure Fire,111,111 - Building fire,20000,40000,60000,417200,357200
18-0029960,2018,Autumn,9/2/2018,1542 CLARA Louisville KY 40215,Structure Fire,111,111 - Building fire,0,20000,20000,85000,65000
18-0030074,2018,Autumn,9/3/2018,2334 ST LOUIS Louisville KY 40210,Structure Fire,111,111 - Building fire,2000,5000,7000,20000,13000
18-0030190,2018,Autumn,9/4/2018,2720 CANNONS Louisville KY 40205,Vehicle Fire,131,131 - Passenger vehicle fire,NULL,5000,5000,5000,0
18-0030233,2018,Autumn,9/5/2018,1637 BERRY Louisville KY 40215,Structure Fire,111,111 - Building fire,10000,30000,40000,30000,-10000
18-0030370,2018,Autumn,9/6/2018,106 S 40TH 3 Louisville KY 40212,Structure Fire,111,111 - Building fire,NULL,1000,1000,45000,44000
18-0030429,2018,Autumn,9/6/2018,4021 W BROADWAY Louisville KY 40211,Structure Fire,111,111 - Building fire,7500,40432,47932,58910,10978
18-0030572,2018,Autumn,9/7/2018,2337 W OAK Louisville KY 40210,Structure Fire,111,111 - Building fire,7000,12000,19000,30000,11000
18-0030965,2018,Autumn,9/9/2018,2823 CELINA Louisville KY 40213,Structure Fire,111,111 - Building fire,2000,10000,12000,82000,70000
18-0031167,2018,Autumn,9/11/2018,415 E MUHAMMAD ALI 801 City of Louisville KY 40202,Structure Fire,111,111 - Building fire,1000,1000,2000,1000,-1000
18-0031256,2018,Autumn,9/12/2018,33 COLONIAL OAKS 1 Louisville KY 40214,Structure Fire,113,"113 - Cooking fire, confined to container",NULL,500,500,200000,199500
18-0031261,2018,Autumn,9/12/2018,1534 DUMESNIL Louisville KY 40210,Structure Fire,111,111 - Building fire,10000,28000,38000,28000,-10000
18-0031261,2018,Autumn,9/12/2018,1534 DUMESNIL Louisville KY 40210,Structure Fire,111,111 - Building fire,10000,28000,38000,28000,-10000
18-0031261,2018,Autumn,9/12/2018,1534 DUMESNIL Louisville KY 40210,Structure Fire,111,111 - Building fire,10000,28000,38000,28000,-10000
18-0031324,2018,Autumn,9/13/2018,1518 W MARKET Louisville KY 40203,Structure Fire,111,111 - Building fire,1000,5000,6000,164500,158500
18-0031575,2018,Autumn,9/15/2018,N 20TH Louisville KY 40203,Structure Fire,111,111 - Building fire,0,43380,43380,48380,5000
18-0031575,2018,Autumn,9/15/2018,N 20TH Louisville KY 40203,Structure Fire,111,111 - Building fire,0,43380,43380,48380,5000
18-0031575,2018,Autumn,9/15/2018,1921 W Main Louisville KY 40203,Structure Fire,111,111 - Building fire,0,43380,43380,48380,5000
18-0032044,2018,Autumn,9/18/2018,2132 ROWAN 211 Louisville KY 40212,Structure Fire,111,111 - Building fire,100,200,300,763070,762770
18-0032074,2018,Autumn,9/18/2018,I65N City of Louisville KY 40202,Vehicle Fire,132,132 - Road freight or transport vehicle fire,5000,20000,25000,65000,40000
18-0031952,2018,Autumn,9/18/2018,106 SOUTHVIEW Louisville KY 40214,Vehicle Fire,131,131 - Passenger vehicle fire,NULL,1000,1000,5000,4000
18-0031959,2018,Autumn,9/18/2018,616 N 28TH Louisville KY 40212,Vehicle Fire,131,131 - Passenger vehicle fire,NULL,1000,1000,1000,0
18-0032168,2018,Autumn,9/19/2018,1600 RIVER SHORE Louisville KY 40206,Structure Fire,113,"113 - Cooking fire, confined to container",0,700,700,19000000,18999300
18-0032193,2018,Autumn,9/19/2018,2801 YORKSHIRE Louisville KY 40220,Structure Fire,100,"100 - Fire, other",4000,NULL,4000,150000,146000
18-0032485,2018,Autumn,9/21/2018,DIXIE Louisville KY 40210,Vehicle Fire,131,131 - Passenger vehicle fire,NULL,5000,5000,5000,0
18-0032507,2018,Autumn,9/22/2018,I264E City of Louisville KY 40205,Vehicle Fire,131,131 - Passenger vehicle fire,0,2500,2500,3500,1000
18-0032600,2018,Autumn,9/22/2018,N 19TH Louisville KY 40203,Vehicle Fire,131,131 - Passenger vehicle fire,NULL,1500,1500,1500,0
18-0033023,2018,Autumn,9/26/2018,3007 BON AIR Louisville KY 40205,Vehicle Fire,131,131 - Passenger vehicle fire,100,4000,4100,4000,-100
18-0033186,2018,Autumn,9/28/2018,112 STATE Louisville KY 40206,Vehicle Fire,131,131 - Passenger vehicle fire,NULL,5000,5000,5000,0
18-0033222,2018,Autumn,9/28/2018,1220 PLACE NOIR Louisville KY 40203,Structure Fire,111,111 - Building fire,NULL,5000,5000,50000,45000
18-0033273,2018,Autumn,9/28/2018,640 N 27TH Louisville KY 40212,Vehicle Fire,131,131 - Passenger vehicle fire,NULL,900,900,1500,600
18-0033330,2018,Autumn,9/29/2018,1506 BLUEGRASS Louisville KY 40215,Structure Fire,111,111 - Building fire,500,1000,1500,50000,48500
18-0033433,2018,Autumn,9/30/2018,3711 LENTZ Louisville KY 40215,Structure Fire,111,111 - Building fire,1000,2000,3000,49780,46780
18-0033595,2018,Autumn,10/1/2018,I64 East City of Louisville KY 40203,Vehicle Fire,130,"130 - Mobile property (vehicle) fire, other",100,3000,3100,3000,-100
18-0033664,2018,Autumn,10/2/2018,909 E BROADWAY Louisville KY 40204,Vehicle Fire,131,131 - Passenger vehicle fire,NULL,2500,2500,2500,0
18-0033997,2018,Autumn,10/4/2018,West I-64 Louisville KY 40206,Vehicle Fire,132,132 - Road freight or transport vehicle fire,NULL,20000,20000,100000,80000
18-0033877,2018,Autumn,10/4/2018,2628 WILSON Louisville KY 40211,Vehicle Fire,131,131 - Passenger vehicle fire,NULL,1000,1000,5500,4500
18-0033904,2018,Autumn,10/4/2018,I264E City of Louisville KY 40215,Vehicle Fire,131,131 - Passenger vehicle fire,0,5000,5000,5000,0
18-0034030,2018,Autumn,10/5/2018,1914 W MUHAMMAD ALI Louisville KY 40203,Structure Fire,111,111 - Building fire,NULL,10000,10000,17180,7180
18-0034131,2018,Autumn,10/5/2018,3301 BARDSTOWN Louisville KY 40218,Vehicle Fire,131,131 - Passenger vehicle fire,100,9000,9100,9000,-100
18-0034177,2018,Autumn,10/6/2018,1738 S 23RD Louisville KY 40210,Vehicle Fire,131,131 - Passenger vehicle fire,NULL,1000,1000,4000,3000
18-0034182,2018,Autumn,10/6/2018,1210 LARCHMONT Louisville KY 40215,Structure Fire,111,111 - Building fire,1000,6000,7000,69930,62930
18-0034232,2018,Autumn,10/6/2018,718 S 44TH Louisville KY 40211,Structure Fire,111,111 - Building fire,7000,20000,27000,150000,123000
18-0034235,2018,Autumn,10/6/2018,2615 S 6TH Louisville KY 40208,Structure Fire,111,111 - Building fire,1000,8000,9000,40870,31870
18-0034235,2018,Autumn,10/6/2018,2617 S 6TH Louisville KY 40208,Structure Fire,111,111 - Building fire,NULL,1000,1000,40870,39870
18-0034301,2018,Autumn,10/7/2018,S 26TH Louisville KY 40211,Vehicle Fire,131,131 - Passenger vehicle fire,500,2000,2500,2500,0
18-0034319,2018,Autumn,10/7/2018,3440 LARKWOOD Louisville KY 40212,Outside Fire,154,154 - Dumpster or other outside trash receptacle fire,10,20,30,20,-10
18-0034578,2018,Autumn,10/9/2018,2542 ST XAVIER Louisville KY 40212,Structure Fire,111,111 - Building fire,5000,20000,25000,100000,75000
18-0034491,2018,Autumn,10/9/2018,2026 S 16TH Louisville KY 40210,Structure Fire,111,111 - Building fire,NULL,500,500,100000,99500
18-0034605,2018,Autumn,10/10/2018,1310 S 1ST Louisville KY 40208,Structure Fire,111,111 - Building fire,1000,0,1000,215000,214000
18-0034833,2018,Autumn,10/11/2018,50 NICHOLS Louisville KY 40215,Structure Fire,111,111 - Building fire,NULL,1000,1000,8000,7000
18-0034833,2018,Autumn,10/11/2018,48 NICHOLS Louisville KY 40215,Structure Fire,111,111 - Building fire,0,1000,1000,20000,19000
18-0034833,2018,Autumn,10/11/2018,48 NICHOLS Louisville KY 40215,Structure Fire,111,111 - Building fire,NULL,8000,8000,8000,0
18-0034963,2018,Autumn,10/12/2018,139 N 37TH Louisville KY 40212,Structure Fire,111,111 - Building fire,1000,1000,2000,30000,28000
18-0035104,2018,Autumn,10/14/2018,2811 S 5TH Louisville KY 40208,Structure Fire,111,111 - Building fire,5000,20000,25000,32000,7000
18-0035104,2018,Autumn,10/14/2018,2809 S 5TH Louisville KY 40208,Structure Fire,111,111 - Building fire,0,37000,37000,37000,0
18-0035170,2018,Autumn,10/14/2018,1030 BERRY Louisville KY 40215,Structure Fire,111,111 - Building fire,150,NULL,150,75000,74850
18-0035485,2018,Autumn,10/17/2018,526 W ST CATHERINE Louisville KY 40203,Structure Fire,111,111 - Building fire,NULL,3000,3000,450000,447000
18-0035545,2018,Autumn,10/18/2018,S 10TH Louisville KY 40210,Vehicle Fire,131,131 - Passenger vehicle fire,100,1000,1100,1000,-100
18-0035551,2018,Autumn,10/18/2018,1704 HALE Louisville KY 40210,Structure Fire,111,111 - Building fire,0,250,250,14570,14320
18-0035575,2018,Autumn,10/18/2018,321 N 25TH Louisville KY 40212,Structure Fire,111,111 - Building fire,10000,20080,30080,20080,-10000
18-0035624,2018,Autumn,10/18/2018,2319 HALE Louisville KY 40210,Structure Fire,113,"113 - Cooking fire, confined to container",1000,0,1000,50000,49000
18-0035688,2018,Autumn,10/19/2018,109 S 35TH Louisville KY 40212,Structure Fire,111,111 - Building fire,2000,5000,7000,29000,22000
18-0035685,2018,Autumn,10/19/2018,3778 LEXINGTON Louisville KY 40207,Structure Fire,111,111 - Building fire,NULL,15000,15000,718030,703030
18-0035910,2018,Autumn,10/20/2018,523 N 19TH Louisville KY 40203,Structure Fire,111,111 - Building fire,6000,19700,25700,19700,-6000
18-0035966,2018,Autumn,10/21/2018,2728 W MARKET Louisville KY 40212,Vehicle Fire,131,131 - Passenger vehicle fire,50,3000,3050,6000,2950
18-0035997,2018,Autumn,10/21/2018,S 2ND Louisville KY 40202,Vehicle Fire,131,131 - Passenger vehicle fire,100,8000,8100,8000,-100
18-0036071,2018,Autumn,10/22/2018,2100 SPRING 1 Louisville KY 40205,Structure Fire,111,111 - Building fire,0,150,150,400000,399850
18-0036184,2018,Autumn,10/23/2018,2031 PAYNE Louisville KY 40206,Vehicle Fire,137,137 - Camper or recreational vehicle (RV) fire,3000,5000,8000,5000,-3000
18-0036203,2018,Autumn,10/23/2018,I264WB @ Exit 12 City of Louisville KY 40209,Vehicle Fire,131,131 - Passenger vehicle fire,200,1400,1600,1400,-200
18-0036303,2018,Autumn,10/24/2018,2107 W MARKET Louisville KY 40212,Structure Fire,111,111 - Building fire,2500,30000,32500,49130,16630
18-0036314,2018,Autumn,10/24/2018,1836 W HILL Louisville KY 40210,Structure Fire,111,111 - Building fire,5000,30000,35000,65000,30000
18-0036492,2018,Autumn,10/25/2018,113 S 19TH Louisville KY 40203,Structure Fire,111,111 - Building fire,NULL,13500,13500,27000,13500
18-0036523,2018,Autumn,10/26/2018,3322 RUDD Louisville KY 40212,Structure Fire,111,111 - Building fire,NULL,50000,50000,50000,0
18-0036543,2018,Autumn,10/26/2018,I-264 Watterson Expressway @ Dumesnil Louisville KY 40211,Vehicle Fire,131,131 - Passenger vehicle fire,200,10000,10200,10000,-200
18-0036580,2018,Autumn,10/26/2018,4144 TAYLOR Louisville KY 40215,Vehicle Fire,131,131 - Passenger vehicle fire,500,3500,4000,3500,-500
18-0036579,2018,Autumn,10/26/2018,2821 NORTHWESTERN Louisville KY 40212,Structure Fire,111,111 - Building fire,1000,4000,5000,20520,15520
18-0036598,2018,Autumn,10/26/2018,TAYLOR Louisville KY 40215,Vehicle Fire,131,131 - Passenger vehicle fire,NULL,2500,2500,5000,2500
18-0036693,2018,Autumn,10/27/2018,4424 MANN Louisville KY 40215,Structure Fire,111,111 - Building fire,10000,50000,60000,120000,60000
18-0036803,2018,Autumn,10/28/2018,1784 W BOLLING Louisville KY 40210,Structure Fire,111,111 - Building fire,0,10000,10000,20000,10000
18-0036843,2018,Autumn,10/29/2018,2500 ELLIOTT Louisville KY 40211,Structure Fire,111,111 - Building fire,0,7000,7000,31640,24640
18-0036888,2018,Autumn,10/29/2018,2907 W MUHAMMAD ALI Louisville KY 40212,Outside Fire,151,"151 - Outside rubbish, trash or waste fire",10,15,25,15,-10
18-0036897,2018,Autumn,10/29/2018,415 E MUHAMMAD ALI Louisville KY 40202,Structure Fire,111,111 - Building fire,100,2000,2100,2000,-100
18-0037098,2018,Autumn,10/31/2018,1014 SEELBACH Louisville KY 40215,Structure Fire,116,"116 - Fuel burner/boiler malfunction, fire confined",NULL,1500,1500,59000,57500
18-0037286,2018,Winter,11/2/2018,I-71 South City of Louisville KY 40206,Vehicle Fire,131,131 - Passenger vehicle fire,NULL,15000,15000,15000,0
18-0037301,2018,Winter,11/2/2018,175 GILLETTE Louisville KY 40214,Structure Fire,111,111 - Building fire,8000,36000,44000,60000,16000
18-0037499,2018,Winter,11/4/2018,4168 HAZELWOOD Louisville KY 40215,Structure Fire,111,111 - Building fire,3000,12000,15000,65000,50000
18-0037638,2018,Winter,11/5/2018,209 SOUTHWOOD Louisville KY 40214,Structure Fire,111,111 - Building fire,1000,2000,3000,10000,7000
18-0037803,2018,Winter,11/7/2018,407 N 43RD Louisville KY 40212,Structure Fire,111,111 - Building fire,2000,5000,7000,45100,38100
18-0037811,2018,Winter,11/7/2018,W LANSING Louisville KY 40214,Vehicle Fire,131,131 - Passenger vehicle fire,NULL,1500,1500,2500,1000
18-0037873,2018,Winter,11/8/2018,CATALPA Louisville KY 40211,Vehicle Fire,131,131 - Passenger vehicle fire,NULL,9000,9000,16000,7000
18-0037885,2018,Winter,11/8/2018,2519 ROWAN Louisville KY 40212,Structure Fire,111,111 - Building fire,NULL,2500,2500,2500,0
18-0037969,2018,Winter,11/8/2018,1035 Barret Louisville KY 40204,Structure Fire,111,111 - Building fire,5000,10000,15000,200000,185000
18-0037969,2018,Winter,11/8/2018,1310 WINTER Louisville KY 40204,Structure Fire,111,111 - Building fire,5000,10000,15000,200000,185000
18-0038015,2018,Winter,11/9/2018,2727 W CHESTNUT Louisville KY 40211,Vehicle Fire,131,131 - Passenger vehicle fire,0,1000,1000,1000,0
18-0038106,2018,Winter,11/10/2018,322 S PETERSON Louisville KY 40206,FALSE,151,"151 - Outside rubbish, trash or waste fire",NULL,5000,5000,253500,248500
18-0038145,2018,Winter,11/10/2018,2025 BROWNSBORO 311 Louisville KY 40206,Structure Fire,111,111 - Building fire,10000,40000,50000,3450000,3400000
18-0038170,2018,Winter,11/10/2018,4729 CLIFF Louisville KY 40215,Structure Fire,111,111 - Building fire,NULL,47514,47514,79190,31676
18-0038263,2018,Winter,11/11/2018,S 22ND Louisville KY 40210,Vehicle Fire,131,131 - Passenger vehicle fire,0,4225,4225,4225,0
18-0038527,2018,Winter,11/14/2018,414 S 20TH Louisville KY 40203,Structure Fire,111,111 - Building fire,5000,31360,36360,31360,-5000
18-0038774,2018,Winter,11/15/2018,320 N 24TH Louisville KY 40212,Structure Fire,111,111 - Building fire,5000,10000,15000,19000,4000
18-0038783,2018,Winter,11/15/2018,2809 S EDDY Louisville KY 40212,Structure Fire,111,111 - Building fire,0,1000,1000,25000,24000
18-0038791,2018,Winter,11/15/2018,409 FOUNTAIN 3 Louisville KY 40208,Structure Fire,111,111 - Building fire,5000,15000,20000,200000,180000
18-0038921,2018,Winter,11/16/2018,1702 LAFAYETTE 1 Louisville KY 40215,Structure Fire,111,111 - Building fire,2000,20000,22000,150000,128000
18-0038947,2018,Winter,11/16/2018,5318 S 3RD Louisville KY 40214,Structure Fire,113,"113 - Cooking fire, confined to container",5000,5000,10000,50000,40000
18-0038953,2018,Winter,11/16/2018,825 CAMDEN Louisville KY 40215,Vehicle Fire,131,131 - Passenger vehicle fire,100,NULL,100,4000,3900
18-0038976,2018,Winter,11/16/2018,1714 GAGEL Shively KY 40216,Structure Fire,111,111 - Building fire,3000,50000,53000,350000,297000
18-0038986,2018,Winter,11/16/2018,1107 ONEIDA Louisville KY 40214,Structure Fire,113,"113 - Cooking fire, confined to container",5000,5000,10000,80000,70000
18-0039091,2018,Winter,11/18/2018,621 E ST CATHERINE Louisville KY 40203,Structure Fire,111,111 - Building fire,20000,40000,60000,90000,30000
18-0039192,2018,Winter,11/19/2018,1621 PRENTICE Louisville KY 40210,Structure Fire,111,111 - Building fire,10000,20000,30000,30000,0
18-0039301,2018,Winter,11/20/2018,1010 S 3RD Louisville KY 40203,Vehicle Fire,131,131 - Passenger vehicle fire,0,3500,3500,3500,0
18-0039374,2018,Winter,11/20/2018,2222 W MADISON Louisville KY 40211,Structure Fire,111,111 - Building fire,1000,37010,38010,37010,-1000
18-0039405,2018,Winter,11/21/2018,308 N 19TH Louisville KY 40203,Vehicle Fire,131,131 - Passenger vehicle fire,500,2000,2500,2000,-500
18-0039522,2018,Winter,11/22/2018,3009 WENTWORTH Louisville KY 40206,Structure Fire,113,"113 - Cooking fire, confined to container",300,100,400,197440,197040
18-0039559,2018,Winter,11/22/2018,1811 DUBOURG Shively KY 40216,Structure Fire,111,111 - Building fire,2000,5000,7000,57480,50480
18-0039728,2018,Winter,11/24/2018,Baxter Louisville KY 40206,Outside Fire,160,"160 - Special outside fire, other",500,500,1000,500,-500
18-0039776,2018,Winter,11/25/2018,S 3RD Louisville KY 40214,Vehicle Fire,131,131 - Passenger vehicle fire,NULL,1000,1000,25000,24000
18-0039788,2018,Winter,11/25/2018,1008 HAMILTON Louisville KY 40204,Vehicle Fire,131,131 - Passenger vehicle fire,NULL,2500,2500,2500,0
18-0039816,2018,Winter,11/25/2018,409 E MUHAMMAD ALI Louisville KY 40202,Structure Fire,111,111 - Building fire,0,4500,4500,6110000,6105500
18-0039855,2018,Winter,11/25/2018,3710 VERMONT Louisville KY 40211,Outside Fire,151,"151 - Outside rubbish, trash or waste fire",40,40,80,50,-30
18-0039971,2018,Winter,11/27/2018,3725 KLONDIKE 12 Louisville KY 40220,Structure Fire,111,111 - Building fire,10000,75000,85000,325000,240000
18-0039982,2018,Winter,11/27/2018,6517 EVANGELINE Louisville KY 40214,Vehicle Fire,131,131 - Passenger vehicle fire,NULL,2500,2500,2500,0
18-0040282,2018,Winter,11/29/2018,I-65 N City of Louisville KY 40213,Vehicle Fire,131,131 - Passenger vehicle fire,NULL,1500,1500,1500,0
18-0040475,2018,Winter,12/1/2018,3100 NORTHWESTERN PKY Louisville KY 40212,Vehicle Fire,131,131 - Passenger vehicle fire,NULL,5000,5000,5000,0
18-0040488,2018,Winter,12/1/2018,1518 SCHUFF Louisville KY 40205,Structure Fire,111,111 - Building fire,1000,5000,6000,250000,244000
18-0040589,2018,Winter,12/2/2018,1614 REDWOOD Louisville KY 40213,Structure Fire,111,111 - Building fire,10000,15000,25000,60000,35000
18-0040589,2018,Winter,12/2/2018,1614 REDWOOD Louisville KY 40213,Structure Fire,111,111 - Building fire,10000,15000,25000,60000,35000
18-0040621,2018,Winter,12/2/2018,667 SOUTHWESTERN Louisville KY 40211,Structure Fire,111,111 - Building fire,200,78165,78365,104220,25855
18-0040709,2018,Winter,12/3/2018,113 N 38TH Louisville KY 40212,FALSE,531,531 - Smoke or odor removal,500,0,500,50000,49500
18-0040705,2018,Winter,12/3/2018,3034 LARUE Louisville KY 40217,Structure Fire,111,111 - Building fire,40000,40000,80000,125000,45000
18-0040754,2018,Winter,12/4/2018,4145 W BROADWAY Louisville KY 40211,Structure Fire,111,111 - Building fire,10000,15000,25000,50000,25000
18-0040759,2018,Winter,12/4/2018,2514 W JEFFERSON Louisville KY 40212,Structure Fire,111,111 - Building fire,2000,15000,17000,54000,37000
18-0040830,2018,Winter,12/4/2018,568 LILLY Louisville KY 40217,Structure Fire,111,111 - Building fire,15000,65000,80000,65000,-15000
18-0040830,2018,Winter,12/4/2018,570 LILLY Louisville KY 40217,Structure Fire,111,111 - Building fire,NULL,7000,7000,70570,63570
18-0040830,2018,Winter,12/4/2018,566 LILLY Louisville KY 40217,Structure Fire,111,111 - Building fire,0,7000,7000,62500,55500
18-0040919,2018,Winter,12/5/2018,1143 LINCOLN Louisville KY 40208,Structure Fire,111,111 - Building fire,5000,20000,25000,42300,17300
18-0040990,2018,Winter,12/6/2018,4737 SOUTHERN 6 Louisville KY 40214,Structure Fire,113,"113 - Cooking fire, confined to container",NULL,200,200,200,0
18-0041158,2018,Winter,12/7/2018,1807 COMMERCE Louisville KY 40208,Structure Fire,112,112 - Fires in structure other than in a building,500,NULL,500,728540,728040
18-0041160,2018,Winter,12/7/2018,209 ADAMS Louisville KY 40206,Vehicle Fire,131,131 - Passenger vehicle fire,0,2500,2500,2500,0
18-0041274,2018,Winter,12/9/2018,2215 GLENMARY Louisville KY 40204,Structure Fire,111,111 - Building fire,1000,1000,2000,507290,505290
18-0041339,2018,Winter,12/9/2018,2711 GRAND Louisville KY 40211,Structure Fire,111,111 - Building fire,800,10000,10800,24500,13700
18-0041346,2018,Winter,12/9/2018,1420 HUNTOON Louisville KY 40215,Vehicle Fire,131,131 - Passenger vehicle fire,0,1000,1000,5000,4000
18-0041597,2018,Winter,12/12/2018,6619 STRAWBERRY Louisville KY 40214,Structure Fire,111,111 - Building fire,5000,25000,30000,250000,220000
18-0041662,2018,Winter,12/13/2018,3537 S 4TH Louisville KY 40214,Structure Fire,111,111 - Building fire,500,0,500,50000,49500
18-0041764,2018,Winter,12/14/2018,3328 NORTHWESTERN Louisville KY 40212,Structure Fire,111,111 - Building fire,10000,20000,30000,72000,42000
18-0041942,2018,Winter,12/15/2018,5327 HALSEY Louisville KY 40214,Structure Fire,111,111 - Building fire,500,2500,3000,250000,247000
18-0041957,2018,Winter,12/15/2018,2217 GOLDSMITH Louisville KY 40218,Structure Fire,111,111 - Building fire,NULL,75000,75000,886650,811650
18-0041988,2018,Winter,12/15/2018,600 BERGMAN Louisville KY 40203,Structure Fire,111,111 - Building fire,15000,NULL,15000,1154820,1139820
18-0042152,2018,Winter,12/17/2018,414 N 20TH Louisville KY 40203,Structure Fire,111,111 - Building fire,0,5000,5000,29560,24560
18-0042304,2018,Winter,12/19/2018,109 S 20TH Louisville KY 40203,Structure Fire,113,"113 - Cooking fire, confined to container",250,NULL,250,50000,49750
18-0042357,2018,Winter,12/19/2018,1236 MANITAU Louisville KY 40215,Structure Fire,111,111 - Building fire,5000,10000,15000,85000,70000
18-0042432,2018,Winter,12/20/2018,I 65 Northbound City of Louisville KY 40213,Vehicle Fire,131,131 - Passenger vehicle fire,NULL,4000,4000,4000,0
18-0042439,2018,Winter,12/20/2018,2814 N LYTLE Louisville KY 40212,Structure Fire,111,111 - Building fire,NULL,100,100,100,0
18-0042503,2018,Winter,12/20/2018,644 S 39TH Louisville KY 40211,Structure Fire,111,111 - Building fire,500,50,550,32400,31850
18-0042509,2018,Winter,12/20/2018,230 CECIL Louisville KY 40212,Structure Fire,113,"113 - Cooking fire, confined to container",50,500,550,232790,232240
18-0042600,2018,Winter,12/21/2018,984 BARRET Louisville KY 40204,FALSE,531,531 - Smoke or odor removal,300,NULL,300,700000,699700
18-0042817,2018,Winter,12/23/2018,3011 PAMELA 1 Louisville KY 40220,Structure Fire,111,111 - Building fire,7500,50000,57500,250000,192500
18-0042859,2018,Winter,12/23/2018,S 26TH Louisville KY 40211,Vehicle Fire,131,131 - Passenger vehicle fire,NULL,4500,4500,4500,0
18-0042785,2018,Winter,12/23/2018,1914 GRIFFITHS Louisville KY 40203,Structure Fire,111,111 - Building fire,2000,15000,17000,31290,14290
18-0042922,2018,Winter,12/24/2018,I64 East City of Louisville KY 40202,Vehicle Fire,131,131 - Passenger vehicle fire,2000,25000,27000,25000,-2000
18-0043026,2018,Winter,12/25/2018,1224 GARVIN Louisville KY 40203,Structure Fire,111,111 - Building fire,500,5000,5500,170000,164500
18-0043056,2018,Winter,12/25/2018,2600 LE BLANC 5 Louisville KY 40206,Structure Fire,113,"113 - Cooking fire, confined to container",NULL,350,350,275000,274650
18-0043081,2018,Winter,12/26/2018,1356 DIXIE Louisville KY 40210,Structure Fire,111,111 - Building fire,NULL,5000,5000,28000,23000
18-0043145,2018,Winter,12/26/2018,12 NICHOLS Louisville KY 40215,FALSE,154,154 - Dumpster or other outside trash receptacle fire,NULL,2000,2000,60000,58000
18-0043211,2018,Winter,12/27/2018,320 JOE CONWAY Louisville KY 40207,Structure Fire,111,111 - Building fire,5000,20000,25000,10000000,9975000
18-0043348,2018,Winter,12/28/2018,3719 YOUNG Louisville KY 40211,Structure Fire,113,"113 - Cooking fire, confined to container",100,100,200,107000,106800
18-0043322,2018,Winter,12/28/2018,1898 TYLER Louisville KY 40205,Vehicle Fire,138,138 - Off-road vehicle or heavy equipment fire,500,300000,300500,300000,-500
18-0043352,2018,Winter,12/28/2018,Taylorsville City of Louisville KY 40220,Vehicle Fire,131,131 - Passenger vehicle fire,100,4000,4100,4000,-100
18-0043388,2018,Winter,12/28/2018,740 SUTCLIFFE Louisville KY 40211,Structure Fire,113,"113 - Cooking fire, confined to container",100,100,200,55000,54800
18-0043497,2018,Winter,12/30/2018,4579 S 1ST Louisville KY 40214,Structure Fire,111,111 - Building fire,NULL,500,500,75000,74500
18-0043559,2018,Winter,12/30/2018,2114 W KENTUCKY Louisville KY 40210,Structure Fire,113,"113 - Cooking fire, confined to container",250,NULL,250,20000,19750
18-0043685,2018,Winter,12/31/2018,4741 ROCKFORD Shively KY 40216,Structure Fire,111,111 - Building fire,50000,300000,350000,350000,0
18-0043679,2018,Winter,12/31/2018,3745 LENTZ Louisville KY 40215,Structure Fire,111,111 - Building fire,5000,20000,25000,37750,12750
19-0000036,2019,Winter,1/1/2019,3119 W JEFFERSON Louisville KY 40212,Structure Fire,111,111 - Building fire,3000,9000,12000,17000,5000
19-0000036,2019,Winter,1/1/2019,3117 W JEFFERSON Louisville KY 40212,Structure Fire,111,111 - Building fire,0,9000,9000,17000,8000
19-0000085,2019,Winter,1/1/2019,330 CECIL Louisville KY 40212,Structure Fire,111,111 - Building fire,800,0,800,51480,50680
19-0000200,2019,Winter,1/2/2019,225 N CLIFTON Louisville KY 40206,Structure Fire,111,111 - Building fire,NULL,1000,1000,300000,299000
19-0000378,2019,Winter,1/4/2019,222 S 24TH Louisville KY 40212,Structure Fire,111,111 - Building fire,NULL,12010,12010,12010,0
19-0000378,2019,Winter,1/4/2019,220 S 24TH Louisville KY 40212,Structure Fire,111,111 - Building fire,1000,4000,5000,15760,10760
19-0000580,2019,Winter,1/6/2019,3202 HUNSINGER Louisville KY 40220,Structure Fire,111,111 - Building fire,300,0,300,172000,171700
19-0000839,2019,Winter,1/8/2019,225 N CLIFTON Louisville KY 40206,Structure Fire,111,111 - Building fire,10000,100000,110000,525000,415000
19-0000879,2019,Winter,1/9/2019,1846 BOLLING Louisville KY 40210,Structure Fire,111,111 - Building fire,NULL,1000,1000,45900,44900
19-0001497,2019,Winter,1/15/2019,406 LOUIS COLEMAN JR Louisville KY 40212,Structure Fire,113,"113 - Cooking fire, confined to container",100,100,200,74000,73800
19-0001725,2019,Winter,1/17/2019,1269 S JACKSON Louisville KY 40203,Vehicle Fire,131,131 - Passenger vehicle fire,1000,NULL,1000,1000,0
19-0001733,2019,Winter,1/17/2019,4407 EXLEY Louisville KY 40211,Structure Fire,111,111 - Building fire,10000,20000,30000,45000,15000
19-0001813,2019,Winter,1/18/2019,1807 COMMERCE Louisville KY 40208,Vehicle Fire,131,131 - Passenger vehicle fire,NULL,1500,1500,1500,0
19-0001892,2019,Winter,1/19/2019,1717 DUNCAN Louisville KY 40203,Structure Fire,111,111 - Building fire,NULL,1000,1000,18380,17380
19-0002098,2019,Winter,1/21/2019,714 W WOODLAWN 3 Louisville KY 40215,Structure Fire,113,"113 - Cooking fire, confined to container",NULL,300,300,300,0
19-0002075,2019,Winter,1/21/2019,317 N 27TH Louisville KY 40212,Structure Fire,111,111 - Building fire,0,26070,26070,26070,0
19-0002129,2019,Winter,1/21/2019,608 S 24TH Louisville KY 40211,Structure Fire,111,111 - Building fire,500,2000,2500,27080,24580
19-0002132,2019,Winter,1/21/2019,4222 POPLAR LEVEL Louisville KY 40213,Outside Fire,154,154 - Dumpster or other outside trash receptacle fire,0,100,100,1000,900
19-0002138,2019,Winter,1/21/2019,I-264W City of Louisville KY 40213,Vehicle Fire,131,131 - Passenger vehicle fire,1000,5000,6000,5000,-1000
19-0002158,2019,Winter,1/21/2019,3011 LINWOOD Louisville KY 40210,Structure Fire,111,111 - Building fire,3000,5000,8000,20940,12940
19-0002261,2019,Winter,1/22/2019,407 REG SMITH 101 Louisville KY 40208,Structure Fire,111,111 - Building fire,500,5000,5500,1000000,994500
19-0002423,2019,Winter,1/24/2019,1009 S 32ND Louisville KY 40211,Structure Fire,111,111 - Building fire,2500,15000,17500,23000,5500
19-0002449,2019,Winter,1/24/2019,802 BEECHER Louisville KY 40215,Structure Fire,111,111 - Building fire,6000,30000,36000,80000,44000
19-0002460,2019,Winter,1/24/2019,654 LOUIS COLEMAN JR Louisville KY 40211,Vehicle Fire,131,131 - Passenger vehicle fire,200,500,700,2000,1300
19-0002504,2019,Winter,1/24/2019,3116 BANK Louisville KY 40212,Vehicle Fire,131,131 - Passenger vehicle fire,250,2000,2250,2000,-250
19-0002544,2019,Winter,1/25/2019,674 S 36TH Louisville KY 40211,Structure Fire,111,111 - Building fire,5000,10000,15000,23550,8550
19-0002645,2019,Winter,1/26/2019,3600 River Park Louisville KY 40211,Structure Fire,111,111 - Building fire,4000,30000,34000,45260,11260
19-0002750,2019,Winter,1/27/2019,1265 GOSS Louisville KY 40217,Structure Fire,111,111 - Building fire,1000,5000,6000,5000,-1000
19-0002759,2019,Winter,1/27/2019,7900 SHELBYVILLE Louisville KY 40222,Vehicle Fire,131,131 - Passenger vehicle fire,NULL,14000,14000,14000,0
19-0002797,2019,Winter,1/27/2019,1508 KNIGHT Louisville KY 40216,Structure Fire,111,111 - Building fire,15000,50000,65000,114000,49000
19-0002935,2019,Winter,1/28/2019,2130 BELMONT Louisville KY 40218,Vehicle Fire,131,131 - Passenger vehicle fire,NULL,1000,1000,1000,0
19-0002953,2019,Winter,1/29/2019,1521 S 30TH Louisville KY 40211,Vehicle Fire,131,131 - Passenger vehicle fire,0,900,900,900,0
19-0003132,2019,Winter,1/30/2019,1359 S BROOK Louisville KY 40208,Structure Fire,111,111 - Building fire,15000,60000,75000,125400,50400
19-0003192,2019,Winter,1/31/2019,3107 GRAND Louisville KY 40211,Structure Fire,111,111 - Building fire,400,8000,8400,27860,19460
19-0003276,2019,Winter,1/31/2019,2223 MAGAZINE Louisville KY 40211,Structure Fire,111,111 - Building fire,1000,2000,3000,10000,7000
19-0003329,2019,Spring,2/1/2019,S 38TH Louisville KY 40212,Vehicle Fire,131,131 - Passenger vehicle fire,0,2000,2000,2000,0
19-0003369,2019,Spring,2/1/2019,523 E BARBEE Louisville KY 40217,Structure Fire,111,111 - Building fire,1000,1000,2000,81040,79040
19-0003480,2019,Spring,2/2/2019,1034 ELLISON Louisville KY 40204,Structure Fire,111,111 - Building fire,30000,60000,90000,142000,52000
19-0003520,2019,Spring,2/2/2019,500BLK CAMP Louisville KY 40203,Vehicle Fire,131,131 - Passenger vehicle fire,100,8000,8100,8000,-100
19-0003650,2019,Spring,2/3/2019,429 MARSHALL Louisville KY 40214,Vehicle Fire,131,131 - Passenger vehicle fire,NULL,5000,5000,5000,0
19-0003828,2019,Spring,2/5/2019,3116 KLONWAY Louisville KY 40220,Vehicle Fire,131,131 - Passenger vehicle fire,2500,14000,16500,14000,-2500
19-0003936,2019,Spring,2/6/2019,102 SAUNDERS Louisville KY 40211,Structure Fire,111,111 - Building fire,3000,20000,23000,23780,780
19-0004110,2019,Spring,2/7/2019,2825 BROWNSBORO Louisville KY 40206,Vehicle Fire,131,131 - Passenger vehicle fire,NULL,1000,1000,1000,0
19-0004121,2019,Spring,2/7/2019,S 4TH Louisville KY 40202,Structure Fire,112,112 - Fires in structure other than in a building,NULL,5000,5000,4100000,4095000
19-0004247,2019,Spring,2/8/2019,2705 CAMERON Louisville KY 40205,Structure Fire,123,"123 - Fire in portable building, fixed location",25,100,125,100,-25
19-0004271,2019,Spring,2/9/2019,2610 ROWAN Louisville KY 40212,Structure Fire,111,111 - Building fire,1500,29120,30620,29120,-1500
19-0004358,2019,Spring,2/9/2019,2324 FARNSLEY Shively KY 40216,Structure Fire,111,111 - Building fire,5000,10000,15000,88000,73000
19-0004398,2019,Spring,2/10/2019,2403 HIKES Louisville KY 40218,Structure Fire,112,112 - Fires in structure other than in a building,0,5000,5000,300000,295000
19-0004411,2019,Spring,2/10/2019,1048 S 43RD Louisville KY 40211,Structure Fire,111,111 - Building fire,NULL,3000,3000,33800,30800
19-0004514,2019,Spring,2/11/2019,1874 ALLGEIER Louisville KY 40213,Structure Fire,113,"113 - Cooking fire, confined to container",500,NULL,500,125000,124500
19-0004541,2019,Spring,2/11/2019,2601 W CHESTNUT 5 Louisville KY 40211,Structure Fire,113,"113 - Cooking fire, confined to container",25,0,25,150000,149975
19-0004550,2019,Spring,2/11/2019,I 65 Northbound City of Louisville KY 40213,Vehicle Fire,131,131 - Passenger vehicle fire,NULL,3500,3500,3500,0
19-0004658,2019,Spring,2/12/2019,3717 WHEELER Louisville KY 40215,Structure Fire,113,"113 - Cooking fire, confined to container",300,NULL,300,60000,59700
19-0004755,2019,Spring,2/13/2019,5000 S Second Louisville KY 40214,Structure Fire,111,111 - Building fire,4000,15000,19000,78000,59000
19-0004811,2019,Spring,2/14/2019,BERRY Louisville KY 40215,Vehicle Fire,131,131 - Passenger vehicle fire,100,NULL,100,2000,1900
19-0004903,2019,Spring,2/15/2019,631 CALDWELL Louisville KY 40203,Structure Fire,111,111 - Building fire,NULL,1000,1000,48900,47900
19-0004920,2019,Spring,2/15/2019,I-64 East City of Louisville KY 40206,Vehicle Fire,131,131 - Passenger vehicle fire,0,750,750,1500,750
19-0005007,2019,Spring,2/16/2019,1422 TAYLOR Louisville KY 40213,Vehicle Fire,131,131 - Passenger vehicle fire,50,1000,1050,1000,-50
19-0005150,2019,Spring,2/17/2019,524 N 31ST Louisville KY 40212,Structure Fire,111,111 - Building fire,2000,2000,4000,48000,44000
19-0005148,2019,Spring,2/17/2019,1500 OLEANDA 4 Louisville KY 40215,Structure Fire,111,111 - Building fire,1000,10000,11000,192307,181307
19-0005211,2019,Spring,2/18/2019,1422 FALCON Louisville KY 40213,Structure Fire,111,111 - Building fire,5000,30000,35000,150000,115000
19-0005254,2019,Spring,2/18/2019,146 N GALT Louisville KY 40206,Structure Fire,114,"114 - Chimney or flue fire, confined to chimney or flue",5000,5000,10000,168000,158000
19-0005329,2019,Spring,2/19/2019,215 NORTHWESTERN Louisville KY 40212,Structure Fire,111,111 - Building fire,2000,7500,9500,100070,90570
19-0005367,2019,Spring,2/19/2019,525 N 20TH Louisville KY 40203,Structure Fire,111,111 - Building fire,500,NULL,500,30000,29500
19-0005491,2019,Spring,2/21/2019,720 DEARBORN Louisville KY 40211,Structure Fire,111,111 - Building fire,20000,50000,70000,150000,80000
19-0005502,2019,Spring,2/21/2019,319 FREEMAN Louisville KY 40214,Structure Fire,111,111 - Building fire,5000,20000,25000,50000,25000
19-0005550,2019,Spring,2/21/2019,1244 S 4TH Louisville KY 40203,Structure Fire,113,"113 - Cooking fire, confined to container",300,2500,2800,6200000,6197200
19-0005589,2019,Spring,2/21/2019,BERRY Louisville KY 40215,Vehicle Fire,131,131 - Passenger vehicle fire,0,200,200,700,500
19-0005646,2019,Spring,2/22/2019,East I-264 Louisville KY 40220,Vehicle Fire,131,131 - Passenger vehicle fire,NULL,3300,3300,3300,0
19-0005659,2019,Spring,2/22/2019,1039 S SHELBY Louisville KY 40203,Structure Fire,111,111 - Building fire,NULL,5000,5000,100000,95000
19-0005667,2019,Spring,2/22/2019,1414 WALTER Louisville KY 40215,Structure Fire,111,111 - Building fire,10000,50000,60000,55000,-5000
19-0005666,2019,Spring,2/22/2019,2101 STRATHMOOR SMAN KY 40205,Vehicle Fire,131,131 - Passenger vehicle fire,0,5000,5000,5000,0
19-0005667,2019,Spring,2/22/2019,1414 WALTER Louisville KY 40215,Structure Fire,111,111 - Building fire,10000,50000,60000,55000,-5000
19-0005667,2019,Spring,2/22/2019,1414 WALTER Louisville KY 40215,Structure Fire,111,111 - Building fire,10000,50000,60000,55000,-5000
19-0005667,2019,Spring,2/22/2019,1414 WALTER Louisville KY 40215,Structure Fire,111,111 - Building fire,10000,32000,42000,55000,13000
19-0005898,2019,Spring,2/24/2019,1400 LINCOLN Louisville KY 40213,Structure Fire,111,111 - Building fire,NULL,300,300,640330,640030
19-0006103,2019,Spring,2/26/2019,3906 SOUTHERN Louisville KY 40214,Structure Fire,111,111 - Building fire,50,NULL,50,200000,199950
19-0006222,2019,Spring,2/27/2019,1842 MCCLOSKEY Louisville KY 40210,Vehicle Fire,131,131 - Passenger vehicle fire,NULL,7000,7000,7000,0
19-0006236,2019,Spring,2/28/2019,3212 VIRGINIA Louisville KY 40211,Vehicle Fire,131,131 - Passenger vehicle fire,200,5000,5200,13975,8775
19-0006244,2019,Spring,2/28/2019,425 M Louisville KY 40208,Structure Fire,111,111 - Building fire,NULL,40110,40110,51110,11000
19-0006331,2019,Spring,2/28/2019,2425 GRIFFITHS Louisville KY 40212,Structure Fire,111,111 - Building fire,3500,10000,13500,29900,16400
19-0006244,2019,Spring,2/28/2019,423 M Louisville KY 40208,Structure Fire,111,111 - Building fire,NULL,400,400,32720,32320
19-0006356,2019,Spring,3/1/2019,4800 ALLMOND Louisville KY 40214,Structure Fire,112,112 - Fires in structure other than in a building,1000,5000,6000,50000,44000
19-0006363,2019,Spring,3/1/2019,3290 BARDSTOWN Louisville KY 40205,Structure Fire,113,"113 - Cooking fire, confined to container",500,NULL,500,100000,99500
19-0006366,2019,Spring,3/1/2019,7400 3RD STREET Louisville KY 40214,Vehicle Fire,132,132 - Road freight or transport vehicle fire,NULL,20000,20000,150000,130000
19-0006566,2019,Spring,3/3/2019,6302 WISTERIA VIEW 103 Louisville KY 40218,Structure Fire,111,111 - Building fire,30000,320000,350000,750000,400000
19-0006633,2019,Spring,3/3/2019,3617 W BROADWAY Louisville KY 40211,Structure Fire,111,111 - Building fire,500,1000,1500,800000,798500
19-0006725,2019,Spring,3/4/2019,403 W OAK Louisville KY 40203,Vehicle Fire,131,131 - Passenger vehicle fire,500,5000,5500,5000,-500
19-0006802,2019,Spring,3/5/2019,2329 ACKERMAN Louisville KY 40212,Structure Fire,111,111 - Building fire,NULL,1500,1500,25000,23500
19-0006829,2019,Spring,3/5/2019,3757 POWELL Louisville KY 40215,Structure Fire,111,111 - Building fire,0,7000,7000,95000,88000
19-0006860,2019,Spring,3/6/2019,Taylor City of Louisville KY 40215,Vehicle Fire,131,131 - Passenger vehicle fire,NULL,15000,15000,15000,0
19-0006961,2019,Spring,3/6/2019,727 E MARKET Louisville KY 40202,Vehicle Fire,131,131 - Passenger vehicle fire,0,15000,15000,15000,0
19-0006961,2019,Spring,3/6/2019,727 E MARKET Louisville KY 40202,Vehicle Fire,131,131 - Passenger vehicle fire,0,5000,5000,12000,7000
19-0007029,2019,Spring,3/7/2019,2124 W BROADWAY Louisville KY 40211,Structure Fire,111,111 - Building fire,4000,20000,24000,32310,8310
19-0007048,2019,Spring,3/7/2019,1245 S 4TH Louisville KY 40203,Structure Fire,111,111 - Building fire,5000,15000,20000,1600000,1580000
19-0007073,2019,Spring,3/8/2019,2825 KLONDIKE Louisville KY 40218,Structure Fire,111,111 - Building fire,0,350,350,800000,799650
19-0007088,2019,Spring,3/8/2019,790 EASTERN Louisville KY 40217,Vehicle Fire,131,131 - Passenger vehicle fire,NULL,3000,3000,3000,0
19-0007228,2019,Spring,3/9/2019,912 W EVELYN Louisville KY 40215,FALSE,441,"441 - Heat from short circuit (wiring), defective/worn",NULL,200,200,60000,59800
19-0007299,2019,Spring,3/10/2019,1038 MILTON Louisville KY 40217,Structure Fire,111,111 - Building fire,500,1000,1500,70000,68500
19-0007376,2019,Spring,3/10/2019,402 WYNFIELD CLOSE Louisville KY 40206,Structure Fire,111,111 - Building fire,2000,2000,4000,572830,568830
19-0007380,2019,Spring,3/11/2019,1100 S 26TH Louisville KY 40210,Vehicle Fire,131,131 - Passenger vehicle fire,0,2000,2000,2000,0
19-0007403,2019,Spring,3/11/2019,1636 EARL Louisville KY 40215,Structure Fire,111,111 - Building fire,0,10000,10000,70000,60000
19-0007561,2019,Spring,3/12/2019,3131 DUMESNIL Louisville KY 40211,Structure Fire,111,111 - Building fire,500,5585,6085,22340,16255
19-0007590,2019,Spring,3/13/2019,1445 THORNBERRY Louisville KY 40215,FALSE,441,"441 - Heat from short circuit (wiring), defective/worn",NULL,100,100,100000,99900
19-0007884,2019,Spring,3/14/2019,401 W RIVER Louisville KY 40202,Vehicle Fire,130,"130 - Mobile property (vehicle) fire, other",NULL,1000,1000,3000,2000
19-0007753,2019,Spring,3/14/2019,1052 S 32ND Louisville KY 40211,Structure Fire,111,111 - Building fire,5000,7000,12000,22850,10850
19-0008008,2019,Spring,3/15/2019,9th Louisville KY 40202,Structure Fire,112,112 - Fires in structure other than in a building,50,100,150,100,-50
19-0007973,2019,Spring,3/15/2019,537 S 3RD 413 Louisville KY 40202,Structure Fire,111,111 - Building fire,500,100,600,9500000,9499400
19-0008265,2019,Spring,3/18/2019,414 MOCKINGBIRD HILL MOVL KY 40207,Structure Fire,111,111 - Building fire,500,15000,15500,760000,744500
19-0008271,2019,Spring,3/18/2019,421 MONTANA Louisville KY 40208,Structure Fire,111,111 - Building fire,NULL,33240,33240,33240,0
19-0008362,2019,Spring,3/18/2019,BARDSTOWN Louisville KY 40205,Vehicle Fire,131,131 - Passenger vehicle fire,0,2500,2500,2500,0
19-0008453,2019,Spring,3/19/2019,2745 GRINSTEAD 112 Louisville KY 40206,Structure Fire,113,"113 - Cooking fire, confined to container",150,0,150,130000,129850
19-0008769,2019,Spring,3/22/2019,1220 W WOODLAWN Louisville KY 40215,Structure Fire,111,111 - Building fire,NULL,2000,2000,65000,63000
19-0008849,2019,Spring,3/23/2019,2817 GREENWOOD Louisville KY 40211,FALSE,140,"140 - Natural vegetation fire, other",NULL,300,300,50000,49700
19-0008970,2019,Spring,3/24/2019,1616 ORCHARD Louisville KY 40213,Structure Fire,111,111 - Building fire,500,500,1000,500,-500
19-0009103,2019,Spring,3/26/2019,2802 TAYLORSVILLE Louisville KY 40205,Structure Fire,111,111 - Building fire,NULL,3000,3000,100000,97000
19-0009193,2019,Spring,3/26/2019,3727 CRAIG Louisville KY 40215,Structure Fire,111,111 - Building fire,5000,20000,25000,75000,50000
19-0009221,2019,Spring,3/27/2019,4132 S 5TH Louisville KY 40214,Structure Fire,111,111 - Building fire,5000,20000,25000,40000,15000
19-0009450,2019,Spring,3/28/2019,830 S HANCOCK Louisville KY 40203,Structure Fire,113,"113 - Cooking fire, confined to container",1000,1000,2000,1000,-1000
19-0009572,2019,Spring,3/29/2019,2001 W MUHAMMAD ALI Louisville KY 40203,Structure Fire,111,111 - Building fire,NULL,100,100,42170,42070
19-0009687,2019,Spring,3/30/2019,216 N 34TH Louisville KY 40212,Structure Fire,111,111 - Building fire,250,10000,10250,25000,14750
19-0009833,2019,Spring,4/1/2019,111 S 19TH Louisville KY 40203,Structure Fire,111,111 - Building fire,0,19010,19010,19010,0
19-0010006,2019,Spring,4/2/2019,218 DR W J HODGE 3 Louisville KY 40203,Structure Fire,111,111 - Building fire,1000,500,1500,92000,90500
19-0010061,2019,Spring,4/3/2019,I-64 City of Louisville KY 40207,Vehicle Fire,131,131 - Passenger vehicle fire,NULL,10000,10000,10000,0
19-0010107,2019,Spring,4/3/2019,664 LOUIS COLEMAN JR Louisville KY 40211,Structure Fire,111,111 - Building fire,1000,2000,3000,25910,22910
19-0010149,2019,Spring,4/3/2019,4120 GARLAND Louisville KY 40211,Outside Fire,154,154 - Dumpster or other outside trash receptacle fire,0,15,15,15,0
19-0010160,2019,Spring,4/3/2019,2519 GREENWOOD Louisville KY 40210,Vehicle Fire,131,131 - Passenger vehicle fire,NULL,1100,1100,1100,0
19-0010245,2019,Spring,4/4/2019,1323 LACONA Louisville KY 40213,FALSE,151,"151 - Outside rubbish, trash or waste fire",NULL,100,100,500,400
19-0010295,2019,Spring,4/5/2019,448 S 38TH 1 Louisville KY 40212,Vehicle Fire,131,131 - Passenger vehicle fire,0,600,600,4000,3400
19-0010342,2019,Spring,4/5/2019,309 N 33RD Louisville KY 40212,Structure Fire,111,111 - Building fire,750,3000,3750,35400,31650
19-0010350,2019,Spring,4/5/2019,201 ADAMS Louisville KY 40206,Structure Fire,113,"113 - Cooking fire, confined to container",200,NULL,200,75000,74800
19-0010460,2019,Spring,4/6/2019,4202 2ND 3 Louisville KY 40214,Structure Fire,111,111 - Building fire,200,200,400,200,-200
19-0010584,2019,Spring,4/7/2019,2754 W MAIN Louisville KY 40212,Structure Fire,113,"113 - Cooking fire, confined to container",0,100,100,54710,54610
19-0011005,2019,Spring,4/11/2019,I 71 South City of Louisville KY 40206,Vehicle Fire,131,131 - Passenger vehicle fire,500,3000,3500,3000,-500
19-0011006,2019,Spring,4/11/2019,I71 South City of Louisville KY 40206,Vehicle Fire,131,131 - Passenger vehicle fire,500,3000,3500,3000,-500
19-0011166,2019,Spring,4/12/2019,418 S 18TH Louisville KY 40203,Structure Fire,111,111 - Building fire,0,200,200,285000,284800
19-0011228,2019,Spring,4/13/2019,2324 W MADISON Louisville KY 40211,Structure Fire,111,111 - Building fire,15000,15000,30000,32980,2980
19-0011236,2019,Spring,4/13/2019,1300 W BROADWAY Louisville KY 40203,Outside Fire,162,162 - Outside equipment fire,250,250,500,250,-250
19-0011432,2019,Spring,4/14/2019,2502 WEICHER Louisville KY 40220,Structure Fire,111,111 - Building fire,500,0,500,125000,124500
19-0011472,2019,Spring,4/15/2019,2213 CRUMS 28 Shively KY 40216,Structure Fire,113,"113 - Cooking fire, confined to container",1000,4000,5000,288000,283000
19-0011536,2019,Spring,4/16/2019,3611 7TH STREET Louisville KY 40216,Vehicle Fire,132,132 - Road freight or transport vehicle fire,1000,30000,31000,30000,-1000
19-0011536,2019,Spring,4/16/2019,3611 7TH STREET Louisville KY 40216,Vehicle Fire,132,132 - Road freight or transport vehicle fire,NULL,2000,2000,15000,13000
19-0011536,2019,Spring,4/16/2019,3611 7TH STREET Louisville KY 40216,Vehicle Fire,132,132 - Road freight or transport vehicle fire,1000,30000,31000,30000,-1000
19-0011675,2019,Spring,4/17/2019,1614 ALGONQUIN 18 Louisville KY 40210,Structure Fire,111,111 - Building fire,200,500,700,250000,249300
19-0011840,2019,Spring,4/18/2019,2204 GERALD 4 Louisville KY 40218,Structure Fire,111,111 - Building fire,350,0,350,195000,194650
19-0012085,2019,Spring,4/21/2019,1819 DATE Louisville KY 40210,Structure Fire,111,111 - Building fire,5000,5000,10000,23760,13760
19-0012257,2019,Spring,4/22/2019,Bardstown City of Louisville KY 40218,Vehicle Fire,131,131 - Passenger vehicle fire,0,8000,8000,10000,2000
19-0012325,2019,Spring,4/23/2019,509 E OAK Louisville KY 40203,Structure Fire,111,111 - Building fire,NULL,10000,10000,33000,23000
19-0012349,2019,Spring,4/23/2019,1244 DIXIE Louisville KY 40210,Vehicle Fire,131,131 - Passenger vehicle fire,0,1000,1000,1000,0
19-0012371,2019,Spring,4/23/2019,327 N 43RD Louisville KY 40212,Structure Fire,111,111 - Building fire,1000,7000,8000,47000,39000
19-0012391,2019,Spring,4/24/2019,2821 ROWAN 1 Louisville KY 40212,Structure Fire,111,111 - Building fire,2500,15000,17500,102000,84500
19-0012451,2019,Spring,4/24/2019,4229 CUTLIFF Louisville KY 40218,Structure Fire,111,111 - Building fire,75,300,375,20000,19625
19-0012573,2019,Spring,4/25/2019,104 S 41ST Louisville KY 40212,Outside Fire,150,"150 - Outside rubbish fire, other",0,1000,1000,50000,49000
19-0012689,2019,Spring,4/27/2019,403 IROQUOIS GARDENS Louisville KY 40214,Structure Fire,111,111 - Building fire,50,NULL,50,1500000,1499950
19-0012753,2019,Spring,4/27/2019,934 SWAN Louisville KY 40204,Structure Fire,111,111 - Building fire,20000,125340,145340,125340,-20000
19-0012753,2019,Spring,4/27/2019,936 SWAN Louisville KY 40204,Structure Fire,111,111 - Building fire,NULL,10000,10000,166900,156900
19-0012753,2019,Spring,4/27/2019,932 SWAN Louisville KY 40204,Structure Fire,111,111 - Building fire,NULL,10000,10000,199900,189900
19-0013688,2019,Summer,5/5/2019,429 ATWOOD Louisville KY 40217,Structure Fire,111,111 - Building fire,15000,45000,60000,75000,15000
19-0013774,2019,Summer,5/6/2019,1918 PEONY Louisville KY 40211,FALSE,151,"151 - Outside rubbish, trash or waste fire",NULL,1000,1000,107770,106770
19-0013938,2019,Summer,5/7/2019,1423 W ORMSBY Louisville KY 40210,Structure Fire,114,"114 - Chimney or flue fire, confined to chimney or flue",0,4000,4000,1000000,996000
19-0014173,2019,Summer,5/9/2019,1842 PORTLAND Louisville KY 40203,Structure Fire,111,111 - Building fire,0,5000,5000,51000,46000
19-0014111,2019,Summer,5/9/2019,3438 POWELL Louisville KY 40215,Structure Fire,111,111 - Building fire,10000,30000,40000,45000,5000
19-0014152,2019,Summer,5/9/2019,3446 ALLISON Louisville KY 40220,Vehicle Fire,131,131 - Passenger vehicle fire,0,1000,1000,3000,2000
19-0014173,2019,Summer,5/9/2019,1840 PORTLAND Louisville KY 40203,Structure Fire,111,111 - Building fire,0,29150,29150,29150,0
19-0014298,2019,Summer,5/11/2019,4137 GREENWOOD Louisville KY 40211,Structure Fire,111,111 - Building fire,0,43000,43000,43000,0
19-0014326,2019,Summer,5/11/2019,3531 TERRIER Louisville KY 40218,Structure Fire,111,111 - Building fire,800,5000,5800,144500,138700
19-0014449,2019,Summer,5/12/2019,321 S SPRING Louisville KY 40206,Structure Fire,111,111 - Building fire,15000,40000,55000,128890,73890
19-0014460,2019,Summer,5/12/2019,1309 CATALPA 206 Louisville KY 40211,Structure Fire,113,"113 - Cooking fire, confined to container",2500,0,2500,30000,27500
19-0014893,2019,Summer,5/16/2019,2100 ST XAVIER Louisville KY 40203,Structure Fire,111,111 - Building fire,18400,36800,55200,36800,-18400
19-0014942,2019,Summer,5/17/2019,264e City of Louisville KY 40222,Vehicle Fire,131,131 - Passenger vehicle fire,NULL,500,500,15000,14500
19-0014963,2019,Summer,5/17/2019,1027 BEECHER Louisville KY 40215,Structure Fire,111,111 - Building fire,8000,25000,33000,48000,15000
19-0015020,2019,Summer,5/17/2019,I264 East City of Louisville KY 40214,Vehicle Fire,131,131 - Passenger vehicle fire,0,7000,7000,7000,0
19-0015166,2019,Summer,5/18/2019,4700 S 3RD Louisville KY 40214,Structure Fire,118,"118 - Trash or rubbish fire, contained",NULL,1000,1000,10000,9000
19-0015342,2019,Summer,5/20/2019,1758 W BURNETT Louisville KY 40210,Structure Fire,111,111 - Building fire,0,30000,30000,80000,50000
19-0015358,2019,Summer,5/20/2019,3532 BROCKTON 4 Louisville KY 40220,Structure Fire,111,111 - Building fire,100,NULL,100,249600,249500
19-0015876,2019,Summer,5/24/2019,3101 POPLAR LEVEL Louisville KY 40217,FALSE,140,"140 - Natural vegetation fire, other",NULL,5,5,10,5
19-0016065,2019,Summer,5/26/2019,2019 WILSON Louisville KY 40210,Structure Fire,111,111 - Building fire,NULL,1000,1000,30870,29870
19-0016065,2019,Summer,5/26/2019,2017 WILSON Louisville KY 40210,Structure Fire,111,111 - Building fire,NULL,200,200,19730,19530
19-0016143,2019,Summer,5/26/2019,2118 BOLLING Louisville KY 40210,Structure Fire,111,111 - Building fire,2000,2000,4000,32000,28000
19-0016155,2019,Summer,5/26/2019,4433 LARKWOOD Louisville KY 40212,Vehicle Fire,131,131 - Passenger vehicle fire,0,2000,2000,2000,0
19-0016310,2019,Summer,5/28/2019,I64 East City of Louisville KY 40206,Vehicle Fire,131,131 - Passenger vehicle fire,0,5000,5000,25000,20000
19-0016361,2019,Summer,5/28/2019,1405 W BROADWAY Louisville KY 40203,Structure Fire,111,111 - Building fire,50000,NULL,50000,885990,835990
19-0016429,2019,Summer,5/28/2019,2400 W MADISON Louisville KY 40211,Structure Fire,111,111 - Building fire,5000,20000,25000,60000,35000
19-0016426,2019,Summer,5/28/2019,337 MAC BRAE Louisville KY 40214,Structure Fire,111,111 - Building fire,NULL,10000,10000,10000,0
19-0016434,2019,Summer,5/28/2019,640 S SHELBY 102 Louisville KY 40202,Structure Fire,111,111 - Building fire,2000,5000,7000,200000,193000
19-0016450,2019,Summer,5/29/2019,1036 S 28TH Louisville KY 40211,Structure Fire,111,111 - Building fire,NULL,500,500,20000,19500
19-0016810,2019,Summer,6/1/2019,1029 LINCOLN Louisville KY 40208,Structure Fire,111,111 - Building fire,NULL,1000,1000,24000,23000
19-0016858,2019,Summer,6/1/2019,S 1ST Louisville KY 40203,Vehicle Fire,131,131 - Passenger vehicle fire,NULL,5000,5000,10000,5000
19-0016886,2019,Summer,6/1/2019,W LANSING Louisville KY 40214,FALSE,561,561 - Unauthorized burning,1,1,2,1,-1
19-0016906,2019,Summer,6/2/2019,ELLIOTT Louisville KY 40211,Vehicle Fire,131,131 - Passenger vehicle fire,500,2000,2500,2000,-500
19-0017034,2019,Summer,6/3/2019,1407 S 4TH 5 Louisville KY 40208,Structure Fire,111,111 - Building fire,5000,25000,30000,495000,465000
19-0017126,2019,Summer,6/3/2019,S 11TH Louisville KY 40208,Vehicle Fire,131,131 - Passenger vehicle fire,NULL,300,300,3000,2700
19-0017129,2019,Summer,6/3/2019,1917 W MADISON 1 Louisville KY 40203,Structure Fire,111,111 - Building fire,1000,500,1500,41000,39500
19-0017183,2019,Summer,6/4/2019,2437 ST XAVIER Louisville KY 40212,Structure Fire,111,111 - Building fire,5000,15000,20000,22000,2000
19-0017183,2019,Summer,6/4/2019,2431 ST XAVIER Louisville KY 40212,Structure Fire,111,111 - Building fire,NULL,2000,2000,50000,48000
19-0017234,2019,Summer,6/4/2019,YORKSHIRE Louisville KY 40220,Outside Fire,160,"160 - Special outside fire, other",1,1,2,1,-1
19-0017277,2019,Summer,6/5/2019,1001 CECIL Louisville KY 40211,Vehicle Fire,131,131 - Passenger vehicle fire,NULL,10000,10000,10000,0
19-0017571,2019,Summer,6/7/2019,1324 S PRESTON Louisville KY 40208,Structure Fire,111,111 - Building fire,5000,10000,15000,45420,30420
19-0017605,2019,Summer,6/7/2019,3000 S 4TH Louisville KY 40208,Structure Fire,111,111 - Building fire,10000,50000,60000,135000,75000
19-0017759,2019,Summer,6/9/2019,1200 HOMEVIEW Louisville KY 40215,Structure Fire,111,111 - Building fire,100,1000,1100,68630,67530
19-0017768,2019,Summer,6/9/2019,2747 W MARKET Louisville KY 40212,Vehicle Fire,131,131 - Passenger vehicle fire,0,1500,1500,5000,3500
19-0017793,2019,Summer,6/9/2019,1376 S 2ND 1 Louisville KY 40208,Structure Fire,111,111 - Building fire,0,500,500,4000001,3999501
19-0017982,2019,Summer,6/10/2019,S 41ST Louisville KY 40211,Vehicle Fire,131,131 - Passenger vehicle fire,0,12700,12700,12700,0
19-0018005,2019,Summer,6/11/2019,430 E ORMSBY Louisville KY 40203,Vehicle Fire,131,131 - Passenger vehicle fire,NULL,8000,8000,10000,2000
19-0018020,2019,Summer,6/11/2019,S 1ST Louisville KY 40202,Vehicle Fire,131,131 - Passenger vehicle fire,NULL,3000,3000,3000,0
19-0018108,2019,Summer,6/11/2019,4041 CHURCHMAN Louisville KY 40215,Vehicle Fire,131,131 - Passenger vehicle fire,NULL,2500,2500,2500,0
19-0018173,2019,Summer,6/12/2019,2100 DUNCAN Louisville KY 40212,Vehicle Fire,131,131 - Passenger vehicle fire,NULL,1500,1500,5000,3500
19-0018238,2019,Summer,6/13/2019,203 NORTHWESTERN Louisville KY 40212,Structure Fire,111,111 - Building fire,3000,20000,23000,91500,68500
19-0018309,2019,Summer,6/13/2019,1329 LACONA Louisville KY 40213,Structure Fire,111,111 - Building fire,0,300,300,400,100
19-0018593,2019,Summer,6/16/2019,3632 BERRY Shively KY 40216,Structure Fire,111,111 - Building fire,0,1000,1000,250000,249000
19-0018664,2019,Summer,6/16/2019,2131 W LEE Louisville KY 40210,Structure Fire,113,"113 - Cooking fire, confined to container",500,NULL,500,60000,59500
19-0018774,2019,Summer,6/17/2019,132 BRECKENRIDGE Louisville KY 40207,Structure Fire,111,111 - Building fire,250000,995000,1245000,19948080,18703080
19-0018774,2019,Summer,6/17/2019,128 BRECKENRIDGE Louisville KY 40207,Structure Fire,111,111 - Building fire,250000,995000,1245000,19948080,18703080
19-0018809,2019,Summer,6/17/2019,717 PALATKA Louisville KY 40214,Structure Fire,111,111 - Building fire,2500,2500,5000,150000,145000
19-0018774,2019,Summer,6/17/2019,130 BRECKENRIDGE Louisville KY 40207,Structure Fire,111,111 - Building fire,250000,995000,1245000,19948080,18703080
19-0018935,2019,Summer,6/18/2019,2100 OSAGE Louisville KY 40210,Structure Fire,111,111 - Building fire,1500,10000,11500,44450,32950
19-0018968,2019,Summer,6/19/2019,1345 S 3RD 5 Louisville KY 40208,Structure Fire,111,111 - Building fire,1200,1200,2400,315000,312600
19-0019016,2019,Summer,6/19/2019,I264E City of Louisville KY 40213,Vehicle Fire,132,132 - Road freight or transport vehicle fire,0,10000,10000,50000,40000
19-0019062,2019,Summer,6/20/2019,125 E KINGSTON Louisville KY 40214,Structure Fire,113,"113 - Cooking fire, confined to container",NULL,500,500,150000,149500
19-0019073,2019,Summer,6/20/2019,264 East City of Louisville KY 40212,FALSE,322,322 - Motor vehicle accident with injuries,0,5000,5000,5000,0
19-0019198,2019,Summer,6/21/2019,S 2ND Louisville KY 40202,Vehicle Fire,131,131 - Passenger vehicle fire,500,NULL,500,2300,1800
19-0019211,2019,Summer,6/21/2019,541 E ORMSBY Louisville KY 40203,Vehicle Fire,131,131 - Passenger vehicle fire,0,1000,1000,1000,0
19-0019524,2019,Summer,6/23/2019,1323 SCHOLAR Louisville KY 40213,Structure Fire,111,111 - Building fire,15000,30000,45000,150000,105000
19-0019593,2019,Summer,6/23/2019,2119 BOLLING Louisville KY 40210,Structure Fire,111,111 - Building fire,NULL,5000,5000,30040,25040
19-0019728,2019,Summer,6/25/2019,1425 BEECH Louisville KY 40211,Vehicle Fire,131,131 - Passenger vehicle fire,NULL,12500,12500,12500,0
19-0019747,2019,Summer,6/25/2019,1 ARENA Louisville KY 40202,Vehicle Fire,131,131 - Passenger vehicle fire,NULL,50000,50000,150000,100000
19-0019912,2019,Summer,6/26/2019,647 DAVIES Louisville KY 40208,Vehicle Fire,131,131 - Passenger vehicle fire,NULL,100,100,500,400
19-0020100,2019,Summer,6/27/2019,1445 LONGFIELD Louisville KY 40215,Structure Fire,111,111 - Building fire,5000,15000,20000,15000,-5000
19-0020100,2019,Summer,6/27/2019,3387 Lester Louisville KY 40215,Structure Fire,111,111 - Building fire,5000,20000,25000,38350,13350
19-0020026,2019,Summer,6/27/2019,519 BEECHER Louisville KY 40215,Structure Fire,111,111 - Building fire,1000,15000,16000,33000,17000
19-0020085,2019,Summer,6/27/2019,S 7TH Louisville KY 40208,Vehicle Fire,131,131 - Passenger vehicle fire,NULL,500,500,2500,2000
19-0020100,2019,Summer,6/27/2019,1443 LONGFIELD Louisville KY 40215,Structure Fire,111,111 - Building fire,5000,15000,20000,15000,-5000
19-0020152,2019,Summer,6/28/2019,1001 LOGAN Louisville KY 40204,Structure Fire,114,"114 - Chimney or flue fire, confined to chimney or flue",15000,0,15000,1700000,1685000
19-0020234,2019,Summer,6/28/2019,3701 W KENTUCKY Louisville KY 40211,Vehicle Fire,130,"130 - Mobile property (vehicle) fire, other",0,1000,1000,1000,0
19-0020370,2019,Summer,6/29/2019,1489 S 4TH Louisville KY 40208,Vehicle Fire,131,131 - Passenger vehicle fire,0,7000,7000,7000,0
19-0020429,2019,Summer,6/30/2019,238 S 41ST Louisville KY 40212,Structure Fire,111,111 - Building fire,5000,15000,20000,60000,40000
19-0020460,2019,Summer,6/30/2019,3622 KAHLERT Louisville KY 40215,Structure Fire,111,111 - Building fire,5000,20000,25000,50000,25000
19-0020480,2019,Summer,7/1/2019,3114 WOODLAND Louisville KY 40211,Structure Fire,111,111 - Building fire,0,53330,53330,57330,4000
19-0020480,2019,Summer,7/1/2019,3112 WOODLAND Louisville KY 40211,Structure Fire,111,111 - Building fire,0,53330,53330,57330,4000
19-0020817,2019,Summer,7/3/2019,1412 HEMLOCK Louisville KY 40211,Structure Fire,111,111 - Building fire,3000,15000,18000,50000,32000
19-0020869,2019,Summer,7/4/2019,800 N 34TH Louisville KY 40212,Vehicle Fire,130,"130 - Mobile property (vehicle) fire, other",NULL,500,500,10000,9500
19-0020884,2019,Summer,7/4/2019,2918 RODMAN Louisville KY 40208,Structure Fire,111,111 - Building fire,NULL,3000,3000,56230,53230
19-0020969,2019,Summer,7/4/2019,I-64w City of Louisville KY 40212,Vehicle Fire,132,132 - Road freight or transport vehicle fire,NULL,1000,1000,20000,19000
19-0020986,2019,Summer,7/4/2019,2545 W JEFFERSON Louisville KY 40212,Structure Fire,111,111 - Building fire,NULL,1000,1000,38360,37360
19-0020995,2019,Summer,7/4/2019,1403 PAUL Louisville KY 40215,Structure Fire,111,111 - Building fire,NULL,1000,1000,70720,69720
19-0021025,2019,Summer,7/5/2019,3317 RUDD Louisville KY 40212,Structure Fire,111,111 - Building fire,0,50260,50260,50260,0
19-0021117,2019,Summer,7/5/2019,3823 KLONDIKE Louisville KY 40218,Structure Fire,111,111 - Building fire,NULL,500,500,178420,177920
19-0021147,2019,Summer,7/6/2019,2129 W Kentucky Louisville KY 40210,Structure Fire,111,111 - Building fire,0,2000,2000,70990,68990
19-0021210,2019,Summer,7/6/2019,2527 W JEFFERSON Louisville KY 40212,Structure Fire,111,111 - Building fire,0,28630,28630,28630,0
19-0021243,2019,Summer,7/6/2019,723 PALATKA Louisville KY 40214,Structure Fire,111,111 - Building fire,500,2000,2500,2000,-500
19-0021265,2019,Summer,7/6/2019,18 EASTOVER Louisville KY 40206,Structure Fire,111,111 - Building fire,0,75000,75000,500000,425000
19-0021281,2019,Summer,7/7/2019,3624 RIVER PARK Louisville KY 40211,Structure Fire,111,111 - Building fire,0,5000,5000,20000,15000
19-0021586,2019,Summer,7/9/2019,104 S 41ST Louisville KY 40212,Structure Fire,111,111 - Building fire,0,2500,2500,30000,27500
19-0021744,2019,Summer,7/11/2019,2550 MAGAZINE Louisville KY 40211,Structure Fire,111,111 - Building fire,0,1000,1000,20800,19800
19-0021802,2019,Summer,7/11/2019,217 W ST CATHERINE Louisville KY 40203,Structure Fire,112,112 - Fires in structure other than in a building,500,500,1000,500,-500
19-0021879,2019,Summer,7/12/2019,545 BARBERRY Louisville KY 40206,Vehicle Fire,131,131 - Passenger vehicle fire,1000,10000,11000,10000,-1000
19-0021897,2019,Summer,7/12/2019,2340 W HILL Louisville KY 40210,Vehicle Fire,131,131 - Passenger vehicle fire,NULL,3800,3800,3800,0
19-0021900,2019,Summer,7/12/2019,S 26TH Louisville KY 40211,Vehicle Fire,131,131 - Passenger vehicle fire,NULL,4000,4000,4000,0
19-0021907,2019,Summer,7/12/2019,I-65 South City of Louisville KY 40202,Vehicle Fire,131,131 - Passenger vehicle fire,500,5000,5500,5000,-500
19-0021928,2019,Summer,7/12/2019,3034 WYANDOTTE Louisville KY 40210,Structure Fire,111,111 - Building fire,3000,12000,15000,24000,9000
19-0022073,2019,Summer,7/13/2019,1314 WALTER Louisville KY 40215,Structure Fire,111,111 - Building fire,NULL,3000,3000,68000,65000
19-0022169,2019,Summer,7/14/2019,64 West City of Louisville KY 40212,Vehicle Fire,131,131 - Passenger vehicle fire,500,3000,3500,3000,-500
19-0022244,2019,Summer,7/15/2019,627 SOUTHWESTERN Louisville KY 40211,Vehicle Fire,131,131 - Passenger vehicle fire,0,13000,13000,13000,0
19-0022481,2019,Summer,7/17/2019,2831 N NORTHWESTERN Louisville KY 40212,Structure Fire,111,111 - Building fire,0,33380,33380,33380,0
19-0022493,2019,Summer,7/17/2019,2809 CELINA Louisville KY 40213,FALSE,151,"151 - Outside rubbish, trash or waste fire",NULL,500,500,500,0
19-0022578,2019,Summer,7/17/2019,3417 BANK Louisville KY 40212,Vehicle Fire,131,131 - Passenger vehicle fire,0,10000,10000,10000,0
19-0022586,2019,Summer,7/17/2019,512 N 20TH Louisville KY 40203,Structure Fire,111,111 - Building fire,0,30360,30360,30360,0
19-0022667,2019,Summer,7/18/2019,1337 S 3RD Louisville KY 40208,Structure Fire,111,111 - Building fire,NULL,1000,1000,200000,199000
19-0022688,2019,Summer,7/18/2019,3228 DUVALLE Louisville KY 40211,Structure Fire,118,"118 - Trash or rubbish fire, contained",NULL,2000,2000,120650,118650
19-0022862,2019,Summer,7/20/2019,827 CAMDEN Louisville KY 40215,Structure Fire,111,111 - Building fire,3000,10000,13000,50000,37000
19-0023196,2019,Summer,7/22/2019,26th City of Louisville KY 40211,Vehicle Fire,131,131 - Passenger vehicle fire,0,1000,1000,2000,1000
19-0023226,2019,Summer,7/23/2019,3014 RADIANCE Louisville KY 40220,Structure Fire,111,111 - Building fire,NULL,2000,2000,176950,174950
19-0023295,2019,Summer,7/23/2019,S 22ND Louisville KY 40211,Vehicle Fire,131,131 - Passenger vehicle fire,0,500,500,500,0
19-0023359,2019,Summer,7/24/2019,2023 PEABODY Louisville KY 40218,Structure Fire,111,111 - Building fire,5000,15000,20000,300000,280000
19-0023481,2019,Summer,7/25/2019,3813 MAMARONECK Louisville KY 40218,Vehicle Fire,131,131 - Passenger vehicle fire,0,7000,7000,7000,0
19-0023714,2019,Summer,7/26/2019,4213 VERMONT Louisville KY 40211,Structure Fire,111,111 - Building fire,0,3000,3000,31520,28520
19-0023719,2019,Summer,7/26/2019,market City of Louisville KY 40203,Vehicle Fire,131,131 - Passenger vehicle fire,0,7000,7000,7000,0
19-0023721,2019,Summer,7/26/2019,W MARKET Louisville KY 40202,Vehicle Fire,131,131 - Passenger vehicle fire,0,7000,7000,7000,0
19-0023791,2019,Summer,7/27/2019,1337 S 3RD 2 Louisville KY 40208,Structure Fire,111,111 - Building fire,NULL,500,500,216750,216250
19-0023910,2019,Summer,7/28/2019,1415 S 2ND Louisville KY 40208,Structure Fire,111,111 - Building fire,0,2000,2000,233100,231100
19-0023921,2019,Summer,7/28/2019,3817 RIVER PARK Louisville KY 40211,Vehicle Fire,131,131 - Passenger vehicle fire,NULL,10000,10000,10000,0
19-0023957,2019,Summer,7/28/2019,935 W JEFFERSON B Louisville KY 40202,Structure Fire,113,"113 - Cooking fire, confined to container",200,0,200,500000,499800
19-0024034,2019,Summer,7/29/2019,201 E JEFFERSON Louisville KY 40202,Outside Fire,142,142 - Brush or brush-and-grass mixture fire,0,5,5,20,15
19-0024148,2019,Summer,7/30/2019,3328 NORTHWESTERN Louisville KY 40212,Structure Fire,111,111 - Building fire,0,4000,4000,4000,0
19-0024162,2019,Summer,7/30/2019,2801 S VIRGINIA Louisville KY 40211,Structure Fire,112,112 - Fires in structure other than in a building,3000,5000,8000,23565,15565
19-0024299,2019,Summer,7/31/2019,CALDWELL Louisville KY 40203,Vehicle Fire,131,131 - Passenger vehicle fire,0,4000,4000,4000,0
19-0024427,2019,Autumn,8/1/2019,4409 EXLEY Louisville KY 40211,Structure Fire,111,111 - Building fire,2000,15000,17000,30140,13140
19-0024609,2019,Autumn,8/2/2019,2735 S 4TH Louisville KY 40208,Structure Fire,111,111 - Building fire,NULL,2000,2000,150000,148000
19-0024612,2019,Autumn,8/2/2019,4 COLLEGE Louisville KY 40203,Structure Fire,111,111 - Building fire,2000,5000,7000,20000,13000
19-0024584,2019,Autumn,8/2/2019,444 W SOUTHLAND Louisville KY 40214,FALSE,162,162 - Outside equipment fire,NULL,30000,30000,30000,0
19-0024865,2019,Autumn,8/4/2019,515 BAXTER Louisville KY 40204,Structure Fire,111,111 - Building fire,NULL,1000,1000,100000,99000
19-0024958,2019,Autumn,8/5/2019,173 N BELLAIRE Louisville KY 40206,Structure Fire,111,111 - Building fire,250,0,250,193350,193100
19-0025065,2019,Autumn,8/6/2019,1515 HEMLOCK Louisville KY 40211,Structure Fire,111,111 - Building fire,NULL,37950,37950,37950,0
19-0025065,2019,Autumn,8/6/2019,1513 Hemlock Louisville KY 40211,Structure Fire,111,111 - Building fire,20000,63455,83455,126910,43455
19-0025121,2019,Autumn,8/6/2019,616 N 23RD Louisville KY 40212,Structure Fire,111,111 - Building fire,100,1000,1100,19000,17900
19-0025180,2019,Autumn,8/7/2019,2126 VILLAGE 10 Louisville KY 40205,Structure Fire,111,111 - Building fire,30000,40000,70000,150000,80000
19-0025180,2019,Autumn,8/7/2019,2126 VILLAGE 12 Louisville KY 40205,Structure Fire,111,111 - Building fire,30000,40000,70000,150000,80000
19-0025180,2019,Autumn,8/7/2019,2126 VILLAGE 8 Louisville KY 40205,Structure Fire,111,111 - Building fire,30000,80000,110000,150000,40000
19-0025228,2019,Autumn,8/7/2019,N 6TH Louisville KY 40202,Vehicle Fire,131,131 - Passenger vehicle fire,5000,5000,10000,5000,-5000
19-0025229,2019,Autumn,8/7/2019,144 N 6TH Louisville KY 40202,Vehicle Fire,131,131 - Passenger vehicle fire,5000,5000,10000,5000,-5000
19-0025505,2019,Autumn,8/9/2019,1206 SEELBACH Louisville KY 40215,Structure Fire,111,111 - Building fire,10000,37500,47500,50000,2500
19-0025505,2019,Autumn,8/9/2019,1206 SEELBACH Louisville KY 40215,Structure Fire,111,111 - Building fire,10000,37500,47500,50000,2500
19-0025574,2019,Autumn,8/10/2019,660 N 28TH Louisville KY 40212,Structure Fire,111,111 - Building fire,0,1000,1000,12600,11600
19-0025658,2019,Autumn,8/10/2019,1264W Louisville KY 40211,Vehicle Fire,131,131 - Passenger vehicle fire,NULL,5000,5000,5000,0
19-0025665,2019,Autumn,8/11/2019,4733 S 1ST 12 Louisville KY 40214,Structure Fire,111,111 - Building fire,NULL,500,500,500,0
19-0025670,2019,Autumn,8/11/2019,518 ATWOOD Louisville KY 40217,Structure Fire,111,111 - Building fire,5000,43790,48790,87580,38790
19-0025730,2019,Autumn,8/11/2019,S FLOYD Louisville KY 40203,Vehicle Fire,131,131 - Passenger vehicle fire,NULL,1000,1000,1000,0
19-0025840,2019,Autumn,8/12/2019,2526 MAGAZINE Louisville KY 40211,Structure Fire,111,111 - Building fire,500,1000,1500,40000,38500
19-0025909,2019,Autumn,8/12/2019,2829 ALTA VISTA Louisville KY 40206,Structure Fire,111,111 - Building fire,0,10000,10000,600000,590000
19-0025928,2019,Autumn,8/12/2019,700 DRESDEN Louisville KY 40215,Outside Fire,151,"151 - Outside rubbish, trash or waste fire",0,500,500,5000,4500
19-0025988,2019,Autumn,8/13/2019,2809 NORTON Louisville KY 40213,Structure Fire,111,111 - Building fire,NULL,2000,2000,92000,90000
19-0026076,2019,Autumn,8/14/2019,S 39TH Louisville KY 40211,Vehicle Fire,131,131 - Passenger vehicle fire,NULL,3000,3000,3000,0
19-0026083,2019,Autumn,8/14/2019,5428 NEW CUT Louisville KY 40214,Vehicle Fire,131,131 - Passenger vehicle fire,500,3000,3500,3000,-500
19-0026289,2019,Autumn,8/15/2019,1014 S 2ND Louisville KY 40203,Structure Fire,100,"100 - Fire, other",100,0,100,20000,19900
